我的账户	101000
查询定活互转	104040
手机银行买基金	117000
如何办理儒商卡	您可以持本人有效身份证件前往我行网点填写申请表后即可办理儒商卡。
儒商卡是否可以代办	儒商卡是可以代办的，建议携带本人及代办人身份证前往柜面办理，代办的卡片需要本人修改初始密码后才可以取款。
儒商卡都有哪些业务免费	我行儒商卡目前有17项免费业务，具体免费项目请咨询4006770537。
儒商卡如何开通自助设备转账业务	您可以持有效身份证件前往我行柜台开通自助设备转账业务。
儒商卡能办理几张附属卡	我行一张儒商卡只能办理一张附属卡。
儒商卡附属卡如何办理	在双方均有意愿的情况下可以为年满16周岁以上的亲属或朋友办理附属卡，办理时需要双方持本人有效身份证件到我行网点柜面办理，该业务不允许代办。
单位给我办的儒商卡，为什么不能取款	按照“人民银行”的要求，代办的账户交易密码均为初始密码，需持本人有效证件到柜台办理修改后方可使用，并且其他渠道暂不支持初始密码修改。
儒商卡取款密码锁定	儒商卡密码累计输入错误5次，为了保护您的账户安全，密码将被系统永久锁定，您需要携带身份证、儒商卡到我行任意网点办理解锁业务后方可正常用卡。
儒商卡损坏如何处理	儒商卡因损坏、变形、磁卡记录消失等原因需要变更时，您应持本人身份证、儒商卡到开卡地区任意网点办理换卡手续。如果您的IC卡丢失或损坏后补卡需要收取10元工本费。
在外地如何把现金存入儒商卡	您可以通过以下方式存入：1.将现金存入他行卡，再汇入我行，是否收取手续费需要向汇出行咨询。2.通过银联柜面通合作机构柜台存入，无手续费。
儒商卡信息错误	儒商卡开户时信息有误，需由本人携带身份证到我行任意网点柜台办理，该业务不可代办，可跨地区办理。
儒商卡正面的日期是开卡日期吗	磁条卡正面为该卡的制卡日期，IC卡正面为该卡的到期日。
其他证件能办理儒商卡吗	没有身份证，可以凭有效期内的临时身份证或户籍证明办理儒商卡开户。
儒商卡能炒股吗	目前我行儒商卡还未开通相关的功能。
儒商卡密码锁定后，哪些业务不受影响	银行卡锁定后，仍可以办理存款业务，同时不影响贷款还款业务，快捷支付业务。
儒商卡挂失如何办理	您可以通过柜面、网上银行、手机银行或者电话银行办理儒商卡的挂失业务。
儒商卡解挂业务	需要您本人持效身份证件和儒商卡前往您办理挂失的原业务经办行进行解挂业务，电话银行口头挂失可以去我行任意支行解挂。
儒商卡和存折的关系	如果您办理的为一卡一折，儒商卡和存折的金额相同，账户不同，卡挂失后，存折可以正常使用，存折挂失后，儒商卡可正常使用。
儒商卡和附属卡的关系	儒商卡和附属卡共用一个账户，儒商卡挂失后，附属卡无法使用，附属卡挂失后，不影响主卡的使用。
如何为未成年人办理儒商卡	未成年子女及监护人携带有效身份证件一同前往柜台办理儒商卡。
儒商卡POS机刷卡的收费标准	只要您持儒商卡在带有银联标志的POS机刷卡消费，我行不收取您的手续费。
儒商卡可以在境外使用吗	在境外您可以持儒商卡在带有银联标志的ATM机上进行取款，我行不会收费您的任何费用。
除了儒商卡还有其他卡种吗	目前我行只有一种人民币借记卡--儒商卡。
儒商卡能存外币吗	在我行的营业部开户的儒商卡是可以办理存入外币业务的。
儒商卡口头挂失取消如何办理	如果您办理儒商卡口头挂失后找回儒商卡，可本人持有效身份证件、儒商卡在我行任意网点办理口头挂失解挂。
儒商卡能在他行的ATM机上存款吗	使用儒商卡目前不支持在其他银行的ATM机办理存款业务。
儒商卡开卡有个数限制吗	我行儒商卡开户时，需要根据您的具体需求开卡。
儒商卡被吞了	1.若是济宁银行卡片在济宁银行ATM机器上被吞卡，建议您首先拨打我行客服热线400-677-0537挂失您的卡片以确保您的账户资金安全。2.若是济宁银行卡片在其他银行的ATM机器上被吞卡，建议您首先拨打我行400-677-0537客服热线挂失您的卡片以确保您的账户资金安全，然后拨打对方银行客服电话咨询吞卡领卡事宜。
儒商卡取款没有吐钞	出现存款未入账或取款未出钞的情况，若自助设备旁有网点请您立即与银行工作人员联系；若自助设备旁无网点或在营业时间外,请您立即致电400-677-0537咨询。此外，请确认设备已恢复广告页面且无其他异常后离开，若有异常请及时拨打400-677-0537。
如何直接使用儒商卡充值话费	您可以在淘宝网站进行充值；也可以登录三大运营商的官网后使用支付宝业务进行充值。
儒商卡口头挂失	WX0001
儒商卡余额查询	您可以通过我行自助设备、电话银行、网上银行、发送短信等途径查询卡内余额。
儒商卡明细查询	WX0100
儒商卡重置密码、更改初始密码能否代办	我行对特殊消费群体有特殊要求，建议咨询就近网点。
什么是周周赢	当您儒商卡余额达到5万元以上并签署周周赢协议后，您的资金将自动转存为理财资金，享受7天通知存款利率，理财周期为7天，7天结束后利息和本金滚入下一轮理财，复利计算。若支取后余额低于最低起存金额的，按支取日一天通知存款利率结清该段利息，剩余资金按活期利率计息。让您的资金在享受活期存款便利的同时，获得较高的收益。
什么是定活自转	定活自转是指我行会将您的活期账户超过2000元的部分转入理财账户，并且按款项存入时间的长短享受最高五年期的定期存款利率，让您在享受活期存取便利的同时，获得较高收益。
什么是投资理财	您可通过我行网上银行、手机银行或去柜台直接办理投资理财的业务，可以实现您儒商卡内的定期账户，通知存款账户的开立和转出，以及我行特色业务的变更以及理财明细的查询服务。
儒商卡IC卡都有哪些业务免费	目前我行只针对IC卡的损坏和挂失换卡业务收取10元换卡/补卡费，其他业务均不收取手续费。
儒商卡IC卡补卡收费标准	按照我行的收费标准，如果您的IC卡丢失或损坏后需要补卡是收取10元换卡/补卡费。
儒商卡IC卡能开立存折吗	按照现行的行业惯例及预防复制卡的出现，IC卡是不能办理存折业务的，但是您可以办理借记卡登记薄。
怎么查询儒商卡IC卡中的余额	您可以通过网银及客服电话4006770537查询，此外如果您开通短信通知业务，也可以发送上行短信“cxye+卡号后四位”即可收到提醒短信。
儒商卡IC卡取款没有吐钞	您可以直接拨打我行客服电话4006770537，将您的取款异常情况详细说明，随后我行将针对您所提供的交易信息进行核查，如情况属实将会通过账务系统为您调账，期间大致需要7个工作日，还请您耐心等待。
济宁银行都有什么理财产品	儒商卡具有特色理财功能，您办理儒商卡后即可享受定活自转或周周赢特色理财，二者只可选其一。
什么是账户明细查询	账户明细查询可以提供查询近期的账户交易明细，查询必须以3个月为一个跨度进行查询，您也可以在网上银行下载明细，最多为5000条，若超出5000条则建议您到您的如上卡开户行打印查询。
存款利息税	目前个人存款利息税暂免。
客户资料维护办理流程	客户资料维护主要是对客户基本资料的增加、修改和删除。基本资料包括名称资料、证件资料、地址资料、通讯资料等内容。您需要持本人有效身份证件到开户行办理客户资料维护业务。
如何进行投诉和建议	如果您需要对我行的服务进行投诉建议,您可以拨打我行的客服电话400-677-0537反映您的问题。
济宁银行有信用卡吗	对不起哦，济宁银行目前没有信用卡业务。
村镇银行的电话是多少	村镇银行的电话为：400-005-3716
什么是支付行号	支付行号又称联行号，是一个地区银行的唯一识别标志。用于人民银行所组织的大额支付系统、小额支付系统、城市商业银行银行汇票系统、全国支票影像系统等跨区域支付业务。
主页人才招聘	关于我行主页人才招聘的问题，请您在招聘页面查看是否有相关部门的联系方式，或者您可以尝试在其他招聘网站看下我行有没有发布相同的招聘信息。
什么是可用余额	可用余额是指借记卡中未冻结部分的余额。
济宁银行的简介	济宁银行，前身为济宁市商业银行，经中国银监会批准，于2006年8月开业，2009年12月更名为济宁银行。感谢您关注我行微信银行，您可在此输入问题咨询我行微信智能客服，或直接拨打我行客服电话400-677-0537进行咨询。
一代身份证能否使用	根据国家法律规定：从2013年1月1日起，停止使用第一代身份证。所有需要持有身份证办理的业务，需要持二代身份证办理。
热线电话号码是多少	我行全国统一服务热线：400-677-0537
代发工资的定义	代发工资是指我行根据与委托单位签订的协议，以转账或现金的方式，将委托单位的职工工资存入职工的活期储蓄存款账户的代理业务。
余额查询的渠道	账户余额可以通过任意一家ATM、我行柜面、电话银行、手机银行、网上银行查询。
我的卡被锁了为什么	借记卡取款密码有5次错误机会，若累计错误次数达到5次将被锁定，锁定后系统不会自动解锁，如若您记得正确密码，请您带本人身份证件到我行任意网办理解锁业务，如若不记得正确密码需本人持本人身份证件到任意我行网点办理密码挂失和密码重置业务。
拨打服务热线的收费标准	拨打400-677-0537我行不会收取任何服务费用，您只需按通话时间向当地通讯公司支付普通市话费。
济宁银行网站的地址	我行唯一的官方网站地址为：www.jn-bank.com
清算中心的电话是多少	我行清算中心的电话为：0537-2216988
个人账户查询密码修改和密码重置的区别	个人账户查询密码修改需要知道原密码才能修改，而查询密码重置是在不知道原密码的情况下，通过验证取款密码来重新设置新的密码。
余额查询	WX0101
明细查询	WX0100
紧急挂失	WX0001
存贷款利率查询	WX0145
汇率查询	WX0145
业务费率查询	WX0145
周边网点	111030
账户绑定	WX0001
解除绑定	WX0001
理财信息	抱歉，该功能尚未开通，敬请期待！
开户行查询	WX0138
银行公告	WX0145
大额预约	WX0142
优惠快讯	WX0145
我要理财	119010|199010|125010|132010|118010|198010
调整默认账号	WX0001
金融信息查询	WX0145
微信投票	抱歉，该功能尚未开通，敬请期待！
转账汇款	102200
他卡余额	抱歉，该功能尚未开通，敬请期待！
生活缴费	您好，登录网上银行，进入用户界面，点击“生活”-“手机充值”，进行查看。
聚一堂	抱歉，该功能尚未开通，敬请期待！
无卡取现	MU0001
特惠商户	LB0102
我的日历	WX0158
微信动账通知签约解约	WX0001
抽奖	WX0159
微信指南	WX0159
取大额现金，需要什么资料	如果您取款超过5万元，需要您提前一天预约，并携带身份证前往支行办理。
取大额现金，是否需要预约	持卡人一次性提取现金人民币5万元（含）以上的，必须至少提前1天向银行网点预约。
我要贷款	您好，您可以到贷款申请页面去做贷款申请，也可直接到网点咨询办理。
火车票查询	WX0159
违章查询	WX0159
快速查询	WX0159
每日天气	WX0159
今日头条	WX0159
网上银行在线客服的作用	您好，使用网上银行遇到问题时，可以咨询在线客服，得到相关的帮助，解答您的疑问。
网上银行如何使用在线客服	您好，使用网上银行在线客服，请您登录网上银行进入个人主页，选择首页页面右下方的在线客服选项，点击进入在线客服页面进行交流。
网上银行留言板有什么作用	你好，如果您有需要反馈的信息，或者有好的建议时，可以通过留言板给我们留言，我们会根据您建议，持续优化我们的网银服务。
网上银行如何进入留言板	您好，网上银行进入留言板，可以点击页面右方的留言板，进行留言，您也可以通过客服中心进入留言板。
网上银行如何查看历史留言及回复	您好，网上银行查看历史留言及回复，通过顶部导航客服中心查看留言板，进行历史留言查看及回复。游客留言暂不支持查阅历史留言。
网上银行如何进行分享	您好，您通过首页下方的分享按钮将我们的网上银行分享给您的朋友；同时，你也可以将我们的理财产品和功能分享给您的朋友，感谢您的支持。
网上银行留言类型都有哪几类	您好，网上银行留言类型有：咨询、建议、投诉、其他。
网上银行搜索功能分为哪几类	您好，网上银行搜索功能目前只支持功能类搜索，您可以通过此功能找到关键词相关的功能。
网上银行搜索功能有什么作用	您好，用户在使用网银的过程中，如果有些功能找不到，或者需要功能相关帮助时，可以使用关键词搜索功能，要查找自己需要的功能。
网上银行怎样进行功能类关键搜索	您好，网上银行功能类搜索，请直接在页面上方的搜索栏输入进行搜索，搜索栏默认为功能类搜索。
网上银行特惠商户有什么作用	您好，网上银行特惠商户，通过在网上银行展示特惠商户信息，为您提供便利。
网上银行如何查看特惠商户	您好，在个人网上银行首页，点击下方的特惠商户查看详情。
网上银行怎么查询特惠商户的详细信息	您好，查询特惠商户详细信息，请您登录进入网上银行，进入特惠商户页面，在特惠商户页面选择类型、城市等，可以查询出商户的详细信息。
网上银行特惠商户详细信息都有哪些	您好，网上银行特惠商户详细信息有：商户名称、联系电话、详细地址、优惠信息详情等。
网上银行特惠商户有地图显示么	您好，网上银行特惠商户地图，请您进入特惠商户页面，选择您想了解的商户，查看详情，可显示商家位置。
网上银行特惠商户的热门商家怎么查看	您好，网上银行特惠商户热门商家查看方法，在个人网上银行首页进入特惠商户页面，可看到热门商家。
网上银行网站地图有什么作用	您好，用户通过网站地图，可以找到个人网上银行所有功能，能展示网银的所有功能，上面放置了网站上需要搜索引擎抓取的所有页面的链接，用户可以通过此功能，方便找到任何一个功能。
网上银行网站地图所有用户都可以使用么	您好，互联网用户、自主注册用户、柜面签约用户，都可查阅网上银行网站地图。
网上银行网站地图怎么查看	您好，查看网上银行网站地图，选择页面顶部导航的帮助，在帮助页面点击网站地图。
网上银行银行公告如何进行查阅	您好，互联网用户、自主注册用户、柜面签约用户，都可查阅我行银行公告，通过首页广告图下方的银行公告会滚动显示，点击可显示详情；同时，您也可以在首页下方点击银行公告进行查阅。
怎么查看常见问题	您好，查询网上银行常见问题，通过顶部导航首页的帮助，进入帮助点击常见问题，选择您想要查询的问题进行查询。
电话缴费	您好，登录网上银行，进入用户界面，点击“生活”-“手机充值”，进行查看。
柜面通合作银行都有哪些	目前您可以在山东省内以及天津、浙江、河北的部分银行办理柜面业务，如咨询具体的网点，建议拨打我行客服热线4006770537。
柜面通业务介绍	柜面通业务是指您持有我行儒商卡，不仅可以在济宁银行网点办理现金存取款业务，还可以在山东省和天津、浙江、河北的部分银行的柜面办理存、取款业务。
积分的查询方式	查询积分有以下几种方式：1.通过我行积分商城查询；2.可以致电4006770537我行客服电话帮助您查询。
什么是积分	儒商卡积分是济宁银行推出一项增值业务，是免费送给您的，您可以使用积分在积分商城兑换商品哦～
积分是怎么来的	积分是根据您的综合用卡情况由系统自动派发赠送的。
积分的使用方法	积分的使用有以下几种方式：1.可以登录积分商城兑换商品；2.可以在济宁贵和太白路店和济宁九龙太白路店使用积分抵现。（兑换成功后会扣除您相应的积分，剩余的积分将继续为您保留。）
积分有效期是多长时间	儒商卡积分目前没有有效期限制，随时使用。
换卡了积分还有吗	如果您的银行卡遗失，原有的积分会给您保留，在您补卡后，原有积分会自动转入您的新卡内。
积分可以兑换什么	在积分商城中您可以使用积分兑换加油卡、体检卡、话费、Q币、实物商品等物品。具体事项您可以登录我行积分商城查询
积分商城怎么登录	积分商城的登录有以下几种方式：1.通过网上银行积分兑换功能登录；2.可以通过我行官网左侧积分商城进入登录。目前仅推荐使用电脑进行登录。
积分兑换加油卡怎么领取	请您在成功提交订单的7个工作日后，携带您的有效身份证原件至您所选择的网点领取积分兑换的加油卡。
积分兑换体检卡怎么领取	请您在成功提交订单的7个工作日后，携带您的有效身份证原件至您所选择的网点领取积分兑换的体检卡。
积分兑换的商品什么时候才能送到	关于商品配送的问题，您可以登录儒意积分商城，查看您的订单信息，如显示“已经发货”，一般会在发货后的5-15日内收到您的礼品。如兑换加油卡、体检卡（自营礼品）需要您在提交订单7个工作日后，携带有效身份证件去您选择的网点领取。
积分兑换的加油卡怎么不能用	因加油卡兑换成功后，需要由油卡归属网点充值，您需再等待3个工作日后才能够使用。并且您需要将加油卡中的金额充值至您所办理的中国石化IC芯片卡内才能够在加油站使用。
积分兑换的商品损坏怎么办	请您在签收积分礼品时打开外包装对商品进行检查，如发现货到即损或货不相符，您可当场拒收并及时联系供应商客服申请更换或保修。如后期使用发现质量问题，您可以联系供应商，在您的礼品签收单左侧，留有礼品供应商的联系电话和地址，如果您有需要，可与礼品供应商进行联络。
积分商城提交的订单怎么取消	您在积分商城的订单一经下单，是无法进行取消的。
积分兑换后长时间没有收到商品怎么办	您可以登录我行儒意积分商城查询当前订单的状态，如果订单状态为“成功”且超过15个工作日还未收到兑换礼品，您可以致电4006-586-286(优讯客服)进行咨询。
积分兑换的商品能代领么	积分兑换的商品是可以代领的。您可以选择指定地址或者其他收货地址后，您或您指定的第三方收货人凭有效证件进行签收即可。
积分不够可以兑换商品么	积分不足是无法兑换您中意的商品的，因积分是没有有效期的，所以您可以等到达到兑换商品分数，再进行兑换。
积分商城礼品供应商的电话是多少	我行积分商城礼品供应商（优讯）的电话为：4006-586-386
积分商城	WX2000
银联在线支付的限额是多少	根据银联要求我行银联在线支付限额为单笔5000元，日累计5000元。
选择银联在线支付需要开通网银吗	您在选择“银联在线-银联卡”支付时是不需要开通网银的。您只需要输入济宁银行儒商卡的卡号、输入您的取款密码、预留手机号码、短信验证码即可支付。
使用银联在线支付可以在哪些网站上进行购物	您可以登录“银联在线支付”官网https://online.unionpay.com查询可以购物的网站。我们可以为您提供几家比较有名网站，例如：12306、京东、苏宁易购、银联在线商城、1号店、东方购物、当当网、南方航空、海南航空、同程网、途牛旅游网、优酷院线等。
通过银联在线-银联卡购物退货时资金如何返还	根据银联规定，您通过“银联在线”支付的订单在取消时，资金将退回您的原支付账户，具体退回时间请咨询购物网站。
我已经开通了银联在线支付功能，还是不能支付	如果您在使用银联在线支付时，提示错误信息：“很抱歉，您的订单未支付成功！失败原因“该银行卡未开通银联在线支付业务（5700000）该卡在银行端已关闭银联在线支付业务”，可能是您在输入账户信息时（输入账号、密码及预留手机号码、短信验证码）连续输入错误3次以上，导致账户状态被锁定，如果您想继续使用银联在线功能则需要由您本人持卡、身份证至我行网点柜面进行解锁处理。
银联在线预留手机号码支付和其他手机号码支付有什么区别	银联在线支付验证手机号码时分为两种形式:1.在支付过程中一般是验证您的银行预留手机号码；2.针对未在银行留存预留手机号码的情况，也可以输入一个常用手机号码进行支付（必须注册银联在线后，在绑定银行卡时，进行设定），但是该支付方式仅是一种临时支付方式，有效期为三个月，并且单日最高限额500元，有效期内累计限额2000元。
银联在线支付时密码输入错误，是否会影响到我其他渠道的支付	银行卡取款密码输入错误次数累计5次，您的账户将会暂时无法使用，需由您本人持卡和有效身份证件到我行任一网点柜面办理解锁。因为银联在线的部分支付方式会在线验证您的银行卡取款密码，如果您输入错误的密码次数过多，将会影响到您的银行卡使用。
使用你们的网银怎么开通银联在线支付	使用我行网银开通银联在线支付只需要登录个人专业版网银选择【银联在线支付】→【银联在线支付设置】，根据提示操作即可。
为什么绑定支付宝时提示手机号码不一致	该手机号码是您在我行第一次开户时预留存的联系方式，不一定是您的短信通知号码。您可以通过到我行网点或者使用我行专业版网银修改您的银行预留号码。
使用支付宝时提示我超限	支付宝限额由支付宝方面统一设置，我行并未对儒商卡的支付做任何限定，具体限额您可以联系支付宝客服中心“95188”进行确认。
怎么在我的支付宝账户中添加儒商卡	支付宝账户添加儒商卡快捷支付的一般流程:1.登录淘宝账号，选择【账号管理】；2.选择【支付宝绑定设置】；3.选择【快捷支付（含卡通）】-【查看】；4.选择【添加银行卡】；5.选择【储蓄卡】，再选择【选择其他银行】；6.在显示的列表里寻找【济宁银行】；7.输入【此卡在银行预留的手机号码】获取校验码。
支付宝银行手机号码怎么修改	银行预留手机号码有两种修改方式：1.如果开通了我行专业版的网上银行，您可以在登录个人网上银行后通过【客户服务】→【个人资料修改】功能修改银行预留号码；2.如果未开通网上银行需要您本人带着身份证和银行卡到我行柜面修改该银行预留号码。
网上银行如何办理	办理企业网上银行您需要携带：1.企业组织机构代码证或同等开户主证件；2.企业经办人身份证、法人授权书（如法人到场办理可不出具）、法人身份证；3.企业相关印鉴以及录入员和授权员的身份证。以上资料均需正本以及各复印件一份。携带以上资料至对公户开户行办理即可。如果办理个人网上银行，1.您可以登录我行主页点击个人网上银行自助注册网银。自助注册的网银目前只能进行余额、交易记录等查询类交易，不可进行转账、汇款等动账类交易。2.您可以携带有效身份证件、儒商卡至柜面办理专业版网银。专业版网银可实现我行网银全部功能。
网上银行的收费标准	目前办理网上银行业务是免费的。并且使用免费，转账同样免除所有手续费哦～
网上银行怎么登录	1.如果您是个人网上银行首次登录，则首先需要选择“卡号/账号登录”输入您的儒商卡号，然后输入您在柜台设定的6位数登录密码即可；如果您是企业网银客户首次登录，则首先需要修改UK密码，然后输入在柜台设定的6位数密码登录修改信息即可；2.如果您是非首次登录，个人客户可根据您的需要选择登录方式输入用户名或卡账号后，输入登录密码即可；企业用户依次输入正确的UK密码和登录密码后即可登录成功。
为什么个人网上银行无法登录	若个人网上银行无法登录：1.提示您“用户名或密码错误”且之前有登录过请您按以下方式尝试解决：核对输入用户名或账号是否正确，并确认登录密码是否正确。若密码忘记可点击登录密码输入栏右侧的“找回密码”重置登录密码；2.若无法自行重置密码需要您本人携带有效身份证件、银行卡至柜面办理找回。
为什么企业网上银行无法登录	如果您的企业网银无法登录，请查看Ukey是否插好，有无正常弹出我行网页，判断UK驱动是否安装，如有疑问请拨打400-677-0537咨询。
为什么网上银行登录密码无法输入	如果您的登录密码无法输入可点击密码输入框后方的“安装安全控件”功能，下载安装完成后，需要您关闭浏览器，重启浏览器后再次登录尝试。
为什么网上银行密码输入后消失了	若输入密码后消失，是因为您输入的密码带有特殊字符。请您在输入时请不要输入*号或#号等特殊字符。
企业网银密码忘记怎么办	企业网银密码分为UK密码和登录密码，密码忘记您需要携带企业组织机构代码证或同等开户主证件、经办人身份证、法人授权书（法人亲自到场可不携带）、法人身份证、企业相关印鉴、另如UK密码忘记还需携带企业网银UK、录入员或授权员的身份证件至您对企业网银开户网点办理。
怎么查询网上银行的开通状态	判断有无开通网上银行有两种方式：1.如果您办理了济宁银行专业版网上银行，柜员会颁发给您一个类似于U盘的设备UK；2.您也可以携带有效身份证件和银行卡至柜面查询。
网银登录中提示：无法显示该网页，提示“此网站的安全证书已过期或尚未生效”怎么回事	如果无法显示网页并提示网站安全证书已过期或尚未生效是由于您电脑系统时间与北京时间不符造成的您可以修改您的电脑系统时间后重启电脑尝试。
个人网银转账输入取款密码，点击确定之后无法弹出UK密码的输入框是怎么回事	如果您点击确定后无法弹出UK密码输入框是因为网上银行进行升级后相应UK控件没有升级到最新版本导致的。您可以通过我行官网下载网银助手进行相应的修复即可；您也可以在网银登录界面点击“工具下载”下载安装相应签名控件即可。
企业网银证书怎么更新	我行网银证书的有效期为两年。在到期前一个月内，请您分别将UKey与电脑连接，然后登录您的企业网上银行，点击“证书管理”-“更新证书”依次进行证书更新、证书下载。若企业网银用户证书到期后，可持企业的相关资料原件（组织机构代码证、营业执照等开户资料，法人代表身份证件、经办人身份证件、授权书、需换发证书操作员的有效身份证件、企业相关印鉴）和USBKey到其网银开户行填写《企业网上银行业务申请表》做证书换发业务。
个人网银怎么加挂账户	个人网银加挂目前分为两种方式：1.您可以登录个人网上银行后，点击“账户管理”-“账户服务”-“账户追加/删除”加挂您的账户。通过该方式加挂的账户无法进行转账等动账类交易。2.您可以携带本人有效身份证、开办专业版网银时的儒商卡、需加挂的儒商卡以及网银UK至柜面加挂。
企业网银怎么加挂账户	企业网银加挂账户需要到企业网银的开户网点办理。需要您携带组织机构代码证、营业执照等开户资料以及法人代表身份证件、经办人身份证件、授权书、操作员、录入员的有效身份证件、企业相关印鉴、企业网银的UK等资料。
什么是网上银行本人账户互转	本人账户互转可为您提供实时签约本人网上银行银行账户间的资金划转。
什么是网上银行行内转账	行内转账是为您提供实时到账的济宁银行内账户的转账。
什么是网上银行跨行转账	跨行转账是使用本行账户转账至他行账户，分为普通和加急两种转账方式，转账5万（不含）以上默认使用加急的转账方式。温馨提示：跨行转账需要知道对方账户的具体开户网点哦~
什么是网上银行跨行快速转账	跨行快速转账是为您提供实时高效的跨行转账业务，但单笔限额必须控制在5万以内。7*24小时随时为您服务。
网上银行如何批量转账	通过批量转账功能可以一次转账多笔行内或行外账户，您可以选择手工录入或文件导入两种方式。1.个人客户操作步骤为“转账汇款-批量转账”；2.企业客户操作步骤为“收付款管理-转账指令管理-批量转账”。
网上银行怎么代发工资	企业网银客户代发工资可以通过“收付款管理-财务支付-代发工资”进入代发工资界面，通过手工录入或文件导入发起代发工资的指令，授权完成后即可完成代发工资。
网上银行怎么预约转账	通过预约转账功能为您提供预约转账的服务，个人客户通过转账汇款-预约转账功能，企业客户通过收付款管理-转账指令管理-预约转账功能；可以设定系统自动转账的指令，到达设定时间由系统自动执行，使您对资金更有规划。您可以通过预约指令管理修改/删除预约的指令。
网上银行转账交易查询可以查什么	通过转账交易查询可以查询绑定网上银行账户转账交易的记录以及转账的状态。您可以点击相应的流水号进行查看或进行电子回单打印。
网上银行如何添加/删除常用收款人	通过收款人名册维护的功能，您可以对您常用的收款人账户进行增加、修改、删除等操作。
网上银行如何缴费支付	您可以登录个人网上银行后，点击“缴费支付”-“自助缴费”进行联通手机号、联通固话号、联通宽带号自助缴费。
什么是网上支付	通过网上支付，您可以使用中国银联的相应付款方式进行网上购物、12306网站购票等一些便捷消费方式。
网上支付怎么使用	网上支付功能需要您签约后使用。您可以登录网上银行后，点击“网上支付”-“网上支付设置”根据提示签约相应儒商卡即可。
个人网银限额如何修改	您可以登录网上银行后，点击“安全中心”-“网银认证方式管理”修改查看您的网上银行限额。
网上银行用户名如何修改	您可以登录个人网上银行后，点击“个人资料”-“用户名”修改查看您的个人网银用户名。
网上银行大额服务时间是多少	我行网上银行大额加急业务服务时间是工作日的上午9点至下午4点。
个人网银如何注销	如果您注销个人网银需要本人携带有效身份证件、银行卡、USBkey至我行柜面办理。如果您只是需要暂停使用网上银行，可以登录网银后点击“安全中心”-“安全设置”-“暂停网银”即可。
企业网银如何注销	企业网银注销需要到您的企业网银开户网点办理。需要您携带组织机构代码证、营业执照等开户资料，以及法人代表身份证件、经办人身份证件、授权书、操作员和录入员账户的有效身份证件、企业相关印鉴等至您的企业网银开户网点办理。
如何打印网上银行电子回单	1.企业网银和个人网银客户均可在我行主页左侧点击电子回单验证的功能，输入电子回单号打印回单。2.或可以登录企业网银后，依次进入“收付款管理”--“电子回单打印”菜单，输入相应查询条件后，页面显示符合条件的转账交易，即可进行电子回单的打印；个人网银可以点击转账汇款-转账交易查询点击流水号打印电子回单。
网上银行电子回单打印异常怎么办	如果电子回单打印异常，您可以尝试清理一下电脑的缓存并重新设置您的打印机，或下载我行网银助手修复电脑后重启电脑再次打印。
个人网银转账限额是多少	个人网银单笔转账限额100万元，日累计转账限额500万元。
企业网银转账限额是多少	企业网银单笔转账限额3000万元，日累计转账限额3000万元。
企业网银公转私限额是多少	企业网银公转私单笔转账限额100万元，日累计转账限额3000万元。
如何注册个人网上银行	在济宁银行门户网站首页上点击“个人网上银行”，进入到个人网上银行登录页面，然后点击“注册”按钮，进入自助注册页面，进行如下操作：1.在线签署《济宁银行股份有限公司电子银行客户服务协议》。2.在线提交如下信息：申请人有效身份证件号码、申请人卡（账号）、设置网上银行初始登录密码、申请人手机号和电子邮箱以及其他所需的资料信息。
个人网上银行大众版和专业版的区别	专业版网上银行需要您本人去我行柜面开通，专业版网银可使用我行为客户提供的全部业务功能。您也可以在我行网站上自助注册网上银行大众版，出于安全考虑，大众版客户只允许使用账户查询、口头挂失，本人账户互转等业务，不能办理跨行转账、缴费支付等业务。
我近期不再使用网上银行，但又不想注销网上银行，该如何办理	您可以通过网上银行自助办理暂停网银服务。
我的个人网银是否可以关联他人账户	为保证您的账户资金安全，网上银行不允许关联他人银行账户，只能关联同一身份证号码下的儒商卡账户。如需向在我行开立的他人账户转账汇款，请您使用行内转账功能。
使用网上银行缴存固话费时，提示“用户档案不存在”	缴存固话费时，提示“用户档案不存在”可能是因为您未输入固话区号造成的。目前我行网上银行仅支持缴存联通固话费，缴存话费时请输入连同区号一起输入，如 “05372887***”。
网上银行通知提醒服务具有什么功能	通知提醒服务是我行推出的网银业务及账户资金变动给予短信提醒的服务，它分为动账短信服务定制和网银短信服务定制，您可以设置动账类短信服务通知和网银短信服务通知业务的签约/解约/修改，为您使用网上银行提供更加安全的保障，使您办理业务更加方便快捷。
在进行网上银行行内同名转账时，无法选择收款账号，怎样处理	1.如果您是个人用户，行内同名转账只可以进行您名下的济宁银行账户间的转账业务，选择不到收款账户是由于您的账户未加挂到网银上造成的。您通过网银上的加挂功能加挂您的账户后即可操作。2.如果您是企业用户，行内同名转账只可以进行您企业的济宁银行账户间的转账业务，选择不到收款账户是由于您的账户未加挂到网银上造成的。您需要到您的开户行加挂您的账户后即可操作。
企业网银操作员录入一笔业务之后如何授权	当操作员录入一笔业务完成后，相关授权员插入自己的USBKey登录企业网银，点击“授权中心——业务分类处理”，点击需要授权的已提交业务进入指令处理界面（此时授权员可点击指令流水号查看指令明细），点击“授权”选择通过或者拒绝。
企业网银首次登录	企业网银首次登录：1.请您将USBKey插入电脑，登录我行网站点击“企业网上银行”，输入UK密码后，即可到达我行企业网银登录界面，系统会回显企业客户号和用户编号，请您确认相应信息后，输入登录密码和验证码，点击“登录”即可。2.初次登录时，需要重新设定网银的登录密码，请您按照页面提示操作即可。
网上银行企业客户证书有效期是多久	目前我行发放给客户的数字证书有效期为两年。
企业网银“跨行快速转账”时，录入员录入成功，进行授权时提示无授权模式	如果您在授权时提示无授权模式，1.需要您登录授权员账户后在“企业管理台”—“授权模式设置”菜单下修改授权模式，将授权模式设定为“无金额”模式；2.然后在“企业管理台”--“开通业务维护”中，为“跨行快速转账”业务选择添加该授权模式即可。
怎样查询企业网银转账额度	如果您需要查询企业网银额度，可以登录企业网银，依次进入“客户服务”--“查询”--“额度查询”，即可查询到您当天通过网银转账的使用额度。
办理网上银行跨行汇款时选择不到收款行，怎么办	您办理跨行汇款业务时，请正确选择收款方的开户行名称，若列表中没有，则请与收款方（或收款行）联系咨询是否可以选择该网点的上级行或其他网点；若仍无法选择收款行，则建议持有效身份证件及款项到我行营业网点办理跨行汇款手续。
网上银行的服务时间	我行网上银行能够提供全天候7×24小时的服务。
网银跨行汇款一般多长时间到账	通过我行网上银行跨行汇款，只要您填写的收款账号、户名、开户行等信息正确无误的情况下，我行系统会立即为您汇出，但由于每个收款银行的系统不同，入账时间有所不同，因此具体到账的时间也会略有不同。请您不要着急，耐心等待一下，如果确实长时间无法到账，您可以再次来电向我们反映，我们将协助您进行查询。
办理网上银行汇款时，系统提示“超出人行大额服务时间”是怎么回事	出现提示“超出人行大额服务时间”的原因是因为您在进行转账时选择了加急或者汇款金额超出了5万元。如果通过我行网上银行汇款时选择“加急”方式，目前只能在正常工作日的9：00－16：00时间段内进行（该时间根据人民银行大额支付系统运行时间确定）。
网上银行向村镇银行转账不成功	通过我行网银向村镇银行转账，建议选择“跨行转账”-“普通模式”即可成功。
更新网上银行证书时，提示CSP错误	如果在更新证书时提示CSP错误，您可以将我行网址加入可信任站点后，再清理缓存并重启浏览器再次尝试下载。
个人网银USB Key丢失了怎么办	USBKey丢失后，您需要去我行营业网点办理证书补发业务，重新申请USBKey。
网上银行UK插入电脑没反应，不弹网页怎么回事	插入UK电脑没有反映可以按以下方式尝试：1.首先请您判断是否USB端口是否正常，您可以将UK插入其他USB端口尝试；2.您可查看是否UK损坏。一代UK与电脑连接后尾部指示灯闪亮，二代UK显示屏显示“济宁银行”字样；3.您也可通过电脑依次点击“开始”-“程序”-“济宁银行网上银行安全组件”找到相应驱动运行；4.登录我行官方网站下载网银助手修复电脑。
网上银行代发工资的功能	通过代发工资功能您可以使用您的企业网上银行向我行银行卡批量转账，省去您发放工资的过程，实时、快捷、高效。最多可一次代发2000笔账户。
网上银行中什么是资金归集	通过资金归集功能，您可以设定相应的规则将您的他行账户资金自动汇集到您的儒商卡中，方便您管理您的资产。
怎么使用网上银行资金归集功能	如果想使用资金归集功能需要做以下的操作：1.首先点击账户管理-协议管理-查询协议签约和支付协议签约，分别签约他行账户；2.其次点击资金归集-资金归集指令管理设定，设定成功后次日即可正常运行。注：您的他行账户的也需要开通UK版的网上银行才可以使用哦~
网上银行UK的PIN码锁定怎么办	USBkey的PIN码累计连续6次输入错误后会被锁定，不能继续使用。解决方法为：1.个人客户需要持本人有效身份证件、银行卡及USBkey到我行营业网点办理相关业务。2.企业用户需要携带组织机构代码证、营业执照等开户资料，以及法人代表身份证件、经办人身份证件、授权书、被锁定操作员或录入员账户的有效身份证件、企业相关印鉴、USBkey等至对公户网银开户网点办理。
如何下载、安装网银UK驱动程序	USBKey插入电脑后，会自动进行安装，安装成功后在您桌面右下角会出现我行证书管理工具图标（我行行标）。如果插入USBKEY,桌面右下角未出现图标，此时需要您手动安装其驱动程序。方法为：插入USBKEY，双击“我的电脑”，在“有移动存储的设备”中可以看到一个带有“JININGBANK”图标的盘符。右键点击该盘符，选择“打开”，运行里面的安装文件即可。或者在我行门户网站下载安装我行网银助手。
网上银行跨行汇款业务时怎么查询收款行	跨行汇款查询收款行方法：1.实时汇款查询收款行时请直接选择收款行的名称；若常用收款行列表中没有，则选择“其他”查询，需要输入收款行名的关键字，多个关键字之间用“#”号间隔；2.快速汇款/普通汇款查询收款行时需要输入收款行名全称的关键字，多个关键字之间用“#”号间隔。
什么是pin码	PIN码是我行USBKEY的密码，他的初始密码是123456，你可以自行更改，更改后既可以是纯数字也可以是字母加数字的组合。
手机银行安全提示	如果您需要了解手机银行在使用时的注意事项，请登录我行官方网站查阅。
手机银行的签约方式	手机银行签约方式分为两种方式：1.个人客户携带本人身份证原件、济宁银行儒商卡和手机，至就近济宁银行营业网点，即可签约开通手机银行；2.企业客户需由企业经办人及手机银行操作员携带本人身份证原件、企业身份证明材料及企业法人授权委托书（法定代表人本人办理时不需要），至账户开户网点，即可签约开通手机银行。
如何下载手机银行	WX0140
手机银行的适配手机机型	目前我行手机银行适配多种机型，具体机型咨询请拨打我行客服热线400-677-0537或直接到我行网点咨询办理。
如何卸载手机银行	因我行手机银行采用芯片技术，建议您携带有效身份证件、儒商卡及手机银行到您的手机银行开户行办理销户业务。
手机银行登录密码设置规则	登录密码用于客户登录手机银行时使用，初始登录密码是123456。首次登录手机银行菜单时，系统会强制请您修改初始登录密码，修改后的密码不能过于简单，系统不允许设置6位的重复数字或连续的数字。
手机银行登录密码锁定规则	手机银行登录密码连续输错6次后会被锁定。如果您的登录密码锁定或忘记，您可以：1.个人客户可以持本人有效身份证件到我行任一营业网点办理登录密码重置；2.企业客户持经办人有效身份证件的原件、法定代表人有效身份证件的复印件（加盖企业公章）、企业法人授权委托书（法定代表人本人办理时不需要），至手机银行签约网点办理登录密码重置。
手机密码支付密码设置规则	支付密码用于客户完成手机银行交易操作时使用的密码，该密码是您办理手机银行业务时在柜面设置的。
批量签约手机银行客户初始支付密码设置规则	批量签约手机银行客户的初始支付密码为签约证件号码去掉最后一位的后6位，证件号码不足7位的初始支付密码为123456。为了您的账户资金安全，建议您激活成功后尽快修改初始支付密码。
手机银行支付密码锁定规则	手机银行支付密码连续输错6次后会被锁定。如果您的支付密码锁定或忘记，您可以：1.个人客户可以持本人有效身份证件到我行任一营业网点办理支付密码重置；2.企业客户可以持经办人有效身份证件的原件、法定代表人有效身份证件的复印件（加盖企业公章）、企业法人授权委托书（法定代表人本人办理时不需要），到手机银行签约网点办理支付密码重置。
手机银行怎么激活	首次使用手机银行时，会提示“卡片激活”，银行系统会与您的手机银行卡进行多次信息交互，请耐心等待。
更换办理手机银行的手机号码	我行一张手机银行卡绑定一个手机号码，所以手机号码更换后，您需要携带相关证明材料去银行柜台办理手机银行签约号码变更：1.个人客户可以持本人有效身份证件到我行任意一个营业网点办理；2.企业客户可以持经办人有效身份证件的原件、法定代表人有效身份证件的复印件（加盖企业公章）、企业法人授权委托书（法定代表人本人办理时不需要），至手机银行签约网点办理。
手机银行丢失	如果您的手机银行丢失，您可以办理挂失。个人客户：1.请您致电我行客户服务热线400-677-0537进行手机银行卡口头挂失后，请客户携带本人身份证件到银行柜面重新申请手机银行卡；2.请客户携带本人身份证件到银行柜面办理挂失后，重新申请手机银行卡。企业客户：需要携带经办人有效身份证件的原件、法定代表人有效身份证件的复印件（加盖企业公章）、企业法人授权委托书（法定代表人本人办理时不需要）至手机银行签约网点办理挂失补卡业务，重新申请手机银行卡。
手机银行能否进行转账汇款	我行手机银行支持转账汇款业务。请问您问的是行内转账还是跨行转账呢?请选择输入转账方式名称查询即可【请选择输入行内转账、跨行转账、手机号转账】。
手机银行转账	请问您问的是行内转账还是跨行转账呢?请选择输入转账方式名称查询即可【请选择输入行内转账、跨行转账、手机号转账】。
手机银行行内转账	请进入手机银行，点击【转账汇款】→【行内转账】，输入相关信息进行转账。
手机银行手机号转账	请进入手机银行客户端，点击【转账汇款】→【行内转账】，选择付款账号，输入收款方手机号及姓名或者通过点击查询按钮选择收款人，根据提示进行操作。
手机银行跨行转账	请进入手机银行，点击【汇款转账】→【实时汇款】、【快速汇款】或【普通汇款】，输入相关信息进行转账。
手机银行什么时候可以转账	行内转账、实时汇款、普通汇款均提供为您提供7×24小时汇款服务；快速汇款的服务时间与中国人民银行大额支付系统服务时间一致，一般为工作日的9:00-16:00。
手机银行转账限额是多少	请问您问的是哪一种转账方式呢?请您选择输入转账方式的名称查询即可【请选择输入行内转账限额、实时汇款限额、快速汇款限额、普通汇款限额、收付款限额、缴费限额、定活互转限额、贷款还款限额、预约取款限额】。
手机银行行内转账限额	行内转账的限额为：1.个人手机银行单笔限额200万元，每日限额200万元  2.企业手机银行单笔限额200万元，每日限额500万元。
手机银行实时汇款限额	实时汇款的限额为：1.个人手机银行单笔限额5万元，每日限额200万元  2.企业手机银行单笔限额5万元，每日限额500万元。
手机银行快速汇款限额	快速汇款的限额为：1.个人手机银行单笔限额200万元，每日限额200万元  2.企业手机银行单笔限额200万元，每日限额500万元。
手机银行普通汇款限额	普通汇款的限额为：1.个人手机银行单笔限额5万元，每日限额200万元  2.企业手机银行单笔限额5万元，每日限额500万元。
手机银行收付款限额	收付款的限额为： 1.个人手机银行单笔限额200万元，每日限额200万元  2.企业手机银行单笔限额200万元，每日限额500万元。
手机银行缴费限额	缴费的限额为单笔限额2000元，每日限额5000元。
手机银行定活互转限额	定活互转的限额为单笔限额200万元，每日限额500万元。
手机银行贷款还款限额	贷款还款的限额为单笔限额200万元，每日限额500万元。
手机银行预约取款限额	预约取款的限额为单笔限额2500元，每日限额5000元。
手机银行转账后什么时候能到	1.转账成功后，行内转账、实时汇款、快速汇款一般实时到账处理；2.转账成功后，普通汇款业务非实时到账，具体到账时间取决于收款行系统，一般情况下，入账时间不超过2个工作日（节假日顺延）。
手机银行如何进行支付宝付款	目前我行手机银行中支持支付宝付款。请进入手机银行，点击【账单管理】-【自助缴费】-【支付宝付款】，输入相关信息进行支付。
手机银行如何缴费	客户端手机银行客户请选择儒意生活——充值缴费功能进行缴费。
手机银行如何给移动缴费	如果您需要向移动号码进行充值，需要选择充值缴费——话费充值功能。
手机银行如何给电信缴费	如果您需要向电信号码进行充值，需要选择充值缴费——话费充值功能。
手机银行如何给联通缴费	客户端手机银行客户请选择儒意生活——充值缴费功能进行缴费。
手机银行缴纳联通宽带费成功后，宽带仍然欠费停机	这是由于您的宽带是在欠费停机后重新缴纳的费用，所以您还需要重新申请开通宽带，具体事宜请联系联通公司。
手机银行如何进行账单发起	请进入手机银行，点击【账单管理】-【账单发起】，输入相关信息进行账单发起，根据提示进行操作。
手机银行如何进行账单支付	请进入手机银行，点击【账单管理】-【账单支付】，输入相关信息进行支付，根据提示进行操作。
手机银行贷款服务	目前我行手机银行支持贷款还款和贷款查询业务。若需要查询使用方式，请直接输入【贷款还款】、【贷款信息查询】查询即可。
手机银行贷款还款	请进入手机银行，点击【贷款服务】-【贷款还款】，选择相应途径还款，可根据提示进行操作。
手机银行贷款信息查询	您可以选择【贷款服务】→【贷款信息查询】自助选择需要查询的贷款信息。
用手机银行怎么在取款机上取款	您可以通过【预约交易】→【预约】进行ATM预约取款，请根据提示进行操作。成功后，请到我行任意一台ATM机上完成取现。
手机银行如何查询预约取款信息	【预约交易】→【预约查询】可为您提供最近五笔预约信息的详情查询。
手机银行如何查询账户信息	您可以通过【查询服务】→【账户信息查询】查询关联账户的账户信息，包括账号、账户余额、账户状态、上次交易日期等。
手机银行如何查询账户余额	请进入手机银行，点击【查询服务】→【账户信息查询】，可查询您下挂账户的余额。
手机银行如何查询账户明细	您可以通过【查询服务】→【账户明细查询】查询指定日期区间的关联账户的历史账务明细。
手机银行如何查询他行的行名行号	您可以通过【查询服务】→【行名行号查询】查询跨行转账时所需的收款行的行名行号，包括实时汇款行名行号和普通/快速汇款行名行号。
手机银行如何查询利率	您可以通过【查询服务】→【利率查询】查询当前我行存款的执行利率和贷款的基准利率。
手机银行如何查询贷款利率	您可以通过【查询服务】→【利率查询】查询当前我行贷款的基准利率。
手机银行如何查询存款利率	您可以通过【查询服务】→【利率查询】查询当前我行存款的执行利率。
手机银行如何查询外汇汇率	您可以通过【查询服务】→【汇率查询】查询当前我行外币的外汇牌价信息。
手机银行怎么联系你们	请进入手机银行，点击【客户服务】→【联系银行客服中心】联系我们。
手机银行如何进行账户挂失	请进入手机银行，点击【客户服务】→【账户口头挂失】，选择您要挂失的账号，根据提示进行操作。
手机银行如何进行卡内定活互转	您可以通过【客户服务】→【个人账户管理】对您的关联账户进行定期转活期、活期转定期等业务的办理。
用手机银行怎样将活期转成定期	您可以通过【客户服务】→【个人账户管理】对您的关联账户进行定期转活期、活期转定期等业务的办理。
用手机银行怎样将定期转成活期	您可以通过【客户服务】→【个人账户管理】对您的关联账户进行定期转活期、活期转定期等业务的办理。
手机银行如何对关联账户的特色业务进行签约或解约	您可以通过【客户服务】→【特色功能签约】对您关联账户的特色业务进行签约或解约。
手机银行如何对关联账户的短信通知业务进行签约或解约	您可以通过【客户服务】→【短信通知签约】对您关联账户的短信通知业务进行签约或解约。
手机银行如何进行关联账户验证	为保证批量签约客户的资金安全，首次登录手机银行的批量签约客户，需通过本交易对其关联账户进行合法性验证，确保客户为关联账户的合法持有人。步骤：您可以通过【系统管理】→【关联账户验证】对您关联账户进行验证。
手机银行中如何添加新的账户	请您本人携带有效身份证件、儒商卡及手机银行到我行网点办理手机银行添加关联账户，我行手机银行最多添加两个关联账户。
手机银行添加账户的条件	手机银行添加账户：1.在手机银行添加的账户必须是您本人名下账户；2.已成功添加到手机银行的账户不能重复追加；3.请您携带有效身份证件、儒商卡及手机银行到我行网点办理。
手机银行最多可以有几个账户	客户端手机银行对添加账号个数，没有限制。
怎样删除手机银行中的账户	手机银行无法自助删除签约账户，需要您携带有效身份证件、签约账户以及手机银行到我行网点办理。
手机银行如何进行常用账户管理	您可以自助添加、修改、删除转账汇款时使用的收款方账户信息，方便下次交易时使用。步骤：您可以通过【系统管理】→【常用账户管理】对您常用的转入账户进行维护。
手机银行如何管理收款人信息	您可以通过【系统管理】→【常用账户管理】对您常用的转入账户进行维护。
手机银行如何进行缴费号码管理	您可以自助添加、修改、删除自助缴费时使用的待缴费号码，方便下次交易时使用。步骤：您可以通过【系统管理】→【缴费号码管理】对您常用的缴费号码进行维护。
手机银行的密码如何修改	请问您问的是手机银行登录密码还是手机银行支付密码呢?请直接输入【修改登录密码】或【修改支付密码】查询。
手机银行登录密码如何修改	您可以通过【系统管理】→【登录密码修改】对您手机银行的登录密码进行自助修改。
手机银行支付密码如何修改	您可以通过【系统管理】→【支付密码修改】对您手机银行的支付密码进行自助修改。
手机银行如何进行关联账户别名设置	您可以通过【系统管理】→【关联账户别名设置】对您手机银行的下挂账户自助修改别名。
手机银行如何进行交易限额的管理	您可以通过【系统管理】→【交易限额管理】自助开通或关闭指定的功能（例如行内转账、快速汇款等），如果是选择开通，则可对单笔交易限额及单日交易限额进行设定。
手机银行如何恢复出厂设置	您可以通过【系统管理】→【恢复出厂设置】将手机银行卡储存信息清空，清空后可以重新激活使用。
手机银行如何关闭提示音	您可以通过【系统管理】→【关闭提示音】关闭手机银行交易提示音。关闭后，您可以再次使用该功能打开提示音。
手机银行如何打开提示音	您可以通过【系统管理】→【关闭提示音】关闭手机银行交易提示音。关闭后，您可以再次使用该功能打开提示音。
手机银行如何进行系统更新	您可以通过【系统管理】→【系统更新】自助进行系统信息更新。
如何查询手机银行卡的信息	您可以通过【系统管理】→【关于我们】自助查询手机银行卡的基本信息，包括序列号、版本号等。
手机银行如何查询最近五笔操作记录	您可以通过【最近信息】查询手机银行最近五笔操作记录。
手机银行企业用户授权卡如何授权	当财务用户卡发起一笔业务后，系统会以短信方式提示授权卡用户有一笔待授权交易需要处理，授权卡用户登录手机银行后，点击【企业服务】→【待授权交易处理】，选择需要授权的业务进入指令处理界面，您可以选择“授权”、“拒绝”或者“删除”，处理完毕后系统会以短信方式告知财务卡用户本笔交易的授权结果。
手机银行企业用户如何查询授权记录	授权卡可以通过【企业服务】→【授权记录查询】对已授权的交易记录进行查询。
手机银行交易时提示“1084手机银行卡检查计数器失败”	出现“1084手机银行卡检查计数器失败”的原因是因为您的操作过快，前一个指令未返回又发出新的指令引起的。1.请您先查看一下账户明细，看您的交易是否已经成功了，如果已经交易成功，请不要重复操作，以免造成重复交易；2.如果交易还未成功，请您耐心等待一下，在等待期间请不要提交新的交易，请您在收到“交易成功”或“交易失败”的返回信息后，再进行新的交易。
手机银行交易时提示“com. Android.phone进程关闭”	出现“com. Android.phone进程关闭”的原因是因为手机系统版本造成的。
手机银行交易时提示“本次操作不成功，未经过您的授权，请咨询10086……”	出现“本次操作不成功，未经过您的授权，请咨询10086……”的原因是因为您的手机号码的梦网（SP）关闭造成的。您只需要拨打10086选择人工服务，重新开通SP服务就可以解决该问题。
手机银行提示“验签失败”	出现“验签失败”的原因是因为交易信息解密是失败造成的。您只需要通过更换新的手机银行卡就可以解决该问题。
手机银行提示“您签约的手机号和手机银行卡号有误，请到柜面查证…”或“签约信息有误”	出现“您签约的手机号和手机银行卡号有误，请到柜面查证…”或“签约信息有误”的原因是因为交易信息解密时失败造成的。您只需要通过更换新的手机银行卡就可以解决该问题。
手机银行提示“MAC校验不通过”	出现“MAC校验不通过”的原因是因为交易信息解密时失败造成的。您只需要通过更换新的手机银行卡就可以解决该问题。
手机银行交易后提示“平台接口校验失败”	出现“平台接口校验失败”的原因是因为您在转账汇款过程中手工输入的行号不正确导致造成的。您只需要查找出正确的行名行号后进行汇款操作即可。
手机银行提示“交易发送成功，请等待银行回应”但是没有回应	出现“请等待银行回应”但是没有回应后，请按照以下步骤进行核查：1.确认手机银行是否处于登录状态，如处于登录状态，请退出才能接收响应信息；2.等待1至2分钟仍然无响应，请先查询确认无回应的交易是否已扣款，如确认已扣款则说明交易已成功，无需重发交易。
手机银行交易提示“发送失败，请联系银行”	出现此问题后，请按照以下步骤进行核查：1.确认您的手机话费是否欠费，如已经欠费请先充值话费。2.确认SIM卡和手机银行卡是否安装正确，如安装不正确或者紧密度不够，建议重新安装后再试。3.确认您的手机收发普通短信是否正常，如发送普通短信不正常，请确认能够正常收发短信。4.建议您电话联系运营商客服确认SP业务是否已经停用，如已停用则需要开启SP业务。
手机银行交易提示“大额服务时间非时序”	出现“大额服务时间非时序”的原因是因为非工作时间采用快速汇款交易造成的。手机银行快速汇款服务时间一般为工作日的9：00－16：30。您可以尝试使用其他的汇款方式：实时汇款或普通汇款。
手机银行交易执行时，手机突然出现异常	如果交易时手机出现异常，可以通过查询账户的余额和交易明细，判断交易是否已成功执行。如已成功执行，无须特殊处理；如未能成功执行，您可以等待手机状态恢复正常后决定是否重新交易。如有疑问或需帮助，请随时致电我行客户服务热线4006770537。
手机银行安装后提示“SIM卡被拒绝”或手机无信号	出现“SIM卡被拒绝”或手机无信号的原因是因为未能正确成功安装造成的。若出现此问题，建议您携带您的手机银行卡和有效身份证件及儒商卡到您的手机银行办理行处理。
我的手机银行可以绑定他人的账户么	为保证您的账户资金安全，您的手机银行不允许关联他人的账户，只能关联您身份证号码下的儒商卡账户，且最多只能关联两个账户。如需向在我行开立的他人账户转账汇款，请您使用行内转账功能。
手机银行交易提示“用户档案不存在”	出现“用户档案不存在”的原因是因为目前我行只支持缴存联通固话费或者您在缴纳联通固话费时未输入区号造成的。若出现此问题，建议您在缴纳联通固话费时请连同区号一起输入，例如 “05372887***”。
怎么打印手机银行的交易记录	1.个人客户在我行手机银行上所做的业务回单可在我行任意网点打印领取；2.企业客户所做的业务回单请至账户开户行打印领取。
什么是手机银行预约交易	为您提供ATM预约取款服务，预约成功后我行发送随机授权码至您的手机银行，您只需凭借预约手机号、授权码和账户取款密码等信息即可在无银行卡的情况下，到我行任意一台ATM机上完成取现。
手机银行登录	我行已推出客户端手机银行，您可以去柜面或是使用专业版网银开通。
手机银行注册	下载我行客户端手机银行后，点击注册输入相关信息，可注册我行大众版手机银行。
个人存款证明的用途	个人存款证明是指济宁银行为储户因涉外事务（出国留学、旅游、探亲、商务等）需要，为其存于本行的个人储蓄存款所提供的证明服务。
个人存款证明如何办理	我行目前仅办理个人定期存款证明业务，您需要本人携带有效身份证件和在我行以本人身份信息开立的个人定期存单/折/卡且账户状态为正常的（未冻结、挂失）,到我行任意网点柜台办理,该业务不可代办。
对公存款证明如何办理	开立对公余额证明需要您到您的开户行办理，需要您提供书面申请并加盖预留印鉴或公章，如不是法人办理还需提供法人和代理人的身份证件原件及复印件及授权书。
存款证明的有效期	个人存款证明的有效期最短一天，最长一年，您可以根据需要自行选择，在有效期内，作为开立个人存款证明的定期存款将被冻结无法正常使用。
开立存款证明的手续费	开立个人存款证明每份收费20元，每次最多可开立5份。对公余额证明每次只能开立1份，收费20元。
开立对公存款证明的份数	开立个人存款证明每份收费20元，单次最多可开立5份；如超过5份可申请追加开立，每次追加开立单次最多开立5份，收费标准为20元/份，且追加开立的存款证明信息与原信息必须一致；目前我行未对追加次数进行限制。
存款证明书是否可以提前解冻	网点受理提前解冻存款证明时，需您能够交回全部开具份数的存款证明原件的情况下，可为您办理解冻业务。若不能交回全部原件，建议您直接与开证网点联系确认。
开立对公账户的条件	在中国境内的机关、团体、部队、企业、事业单位、其他组织的个体工商户和自然人均可开立对公账户。
开立对公账户的收费标准	我行开立对公账户时，无任何费用。
节假日，是否可以办理对公账户存款	可以办理对公账户现金存款，存入当日即可到账。
节假日，是否可以从儒商卡向济宁银行开立的对公账户转账	可以在节假日从儒商卡向济宁银行的对公账户转账，账号户名等信息填写无误，当天即可到账。
对公账户如何办理	我行对公户分三种：基本户、一般户、临时户，请问您想知道哪一种？
对公预留印鉴更换	如您更换预留印鉴请您携带所有的新、旧印鉴和您的旧印鉴卡片客户留存联和更换申请（应详细列明更换原因），到您的开户行填写《更换印鉴卡片申请书》进行更换操作。
对公公章或者财务章丢失	如您丢失单位公章或财务专用章，需要您提供市级以上“登报声明”的报纸原件证明或公安系统出具的相关证明，携带您刻制的新印章，到您的开户行填写《更换印鉴卡片申请书》进行更换操作。
对公法人章或者负责人私章丢失怎么办	如法人章或者负责人私章丢失，请您由单位开具公函说明丢失原因并加盖公章，携带该说明和新刻制的私章到您的开户行即可进行更换。
开立基本存款账户需要什么资料	您好，存款人申请开立基本存款账户,应向银行出具下列证明文件：1.营业执照正本及复印件2份；2.组织机构代码证正本及复印件2份；3.国税、地税税务登记证正本及复印件2份（存款人如为从事生产、经营活动纳税人的，应出具税务部门颁发的税务登记证）；4.印鉴及公章；5.开户申请书。
开立一般存款账户需要什么资料	您好，一般存款账户是存款人因借款或其他结算需要，在基本存款账户开户银行以外的银行营业机构开立的银行结算账户。开立一般存款账户所需材料：1.存款人申请开立一般存款账户，应向银行出具其开立基本存款账户规定的证明文件、基本存款账户开户登记证和下列证明文件：2.营业执照正本及复印件一份；3.组织机构代码证正本及复印件一份；4.国税、地税税务登记证正本及复印件一份；5.法人身份证、公章、法人章或经法人授权的个人名章；6.如法人不能亲自来开户，需法人出具委托书一份，被委托人需提供身份证正本及复印件；7. 开户申请表。
验资户的开立条件	开立验资账户时，所有出资人中至少一人携带本人及其他出资人有效身份证件亲自到我行柜面办理，需要提供的资料包括：工商行政管理部门核发的《企业名称预先核准通知书》及所有出资人身份证原件；民办非企业开立注册验资账户时，柜员应审核民政局的名称预先核准通知书和出资人身份证原件并留存复印件。如出资人为单位的，应提供出资单位资料（营业执照、组织机构代码证、税务登记证、法人代表身份证）。
怎么代办验资户的后续业务	办理验资户后续业务（存入验资资金、出具询证函、退回验资款、销户等）时，如出资人无法亲自到场办理，需要其在办理开户手续时当面出具《开立验资账户授权书》，授权代理人办理后续业务。授权书内容至少包括授权人的姓名、身份证号码以及全权委托验资增资事宜，如出现一切经济纠纷自行承担等内容，并且需要有验资资金占比51%以上的出资人签字。
验资户的资金收付	验资账户在验资期间只收不付，验资账户时间以预先核准通知书上为准，待验资完成并提供有效的证明文件后方可办理正常账务。验资账户需变更时，验资资金必须转入其同名账户。
验资户转基本户	验资户转基本户需要提供的资料包括：1.主证明文件：营业执照、社团登记证等证件正本；2.全国组织机构代码证；3.税务登记证（从事生产经营活动的纳税人）；4.其他证明文件：企业法人或负责人的身份证、代办人身份证等；5.携带公章、财务章、法人章等到开户网点柜台预留正式印鉴。
验资户销户	需销户的验资户在转为一般账户三个工作日后可办理销户，销户资金必须划转到同名账户。
验资户资金返回	验资账户内资金必须全部按照缴款时的方式及金额原路返回，并出具由所有出资人签字的书面申请。
验资户转一般户	验资单位需在验资行开立一般账户，需提供营业执照、组织机构代码证等企业相关证明文件，及基本存款账户开户许可证；开户行报人民银行备案后，验资户可转为一般账户。
外行支票能否在我行受理	您拿外行支票是可以在我行受理的。
外行支票在我行受理，到账时间	如果您上午10点前存入的支票（如无其他特殊原因），当天下午16点后即可到账；10点以后存入的支票，次日11点后即可到账。梁山、微山、泗水不参加济宁同城业务。
节假日，支行是否受理支票业务	节假日，支票业务可以受理，但是需周一为客户处理账务。
购买支票需要什么资料	购买支票请您携带预留印鉴到开户行办理。
购买支票的收费标准	整本支票需支付手续费：15元/本，工本费：5元/本；零星支票需支付手续费：0.6元/份，工本费：0.2元/份。
柜台同行转账手续费	柜台同行转账，免收转账手续费。
柜台现金汇款手续费	您携带现金在我行办理向他行账户的汇款业务，手续费按照转账金额的1%收取，最高50元封底。
柜台跨行转账手续费	柜面转账手续费：0.2万元以下（含）2元 /笔  0.2万-0.5万（含）5元/笔 0.5万-1万（含)10元 /笔  1万-5万（含）15元/笔  5万以上，收取您万分之0.03%的手续费，最高50元封顶。
柜台电汇业务是否可以代办	您可以携带双方身份证件，去我行柜面代为办理电汇业务。
柜台电汇业务代办需要什么资料	代办电汇业务时需携带被代理人的存折（单）卡和客户本人的有效身份证件，代理人还需携带自己的有效身份证件。
如何查询柜台的分布情况	LB0101
节假日柜台是否受理电汇业务	个人客户在节假日可办理5万元(含)以下的电汇业务，对公业务建议您咨询开户行。
什么是银行承兑汇票	银行承兑汇票是由在承兑银行开立存款账户的存款人出票，向开户银行申请并经银行审查同意承兑的，保证在指定日期无条件支付，确定的金额给收款人或持票人的票据。
如何办理银行承兑汇票	办理银行承兑汇票需要您向您的对公户开户行申请。
办理银行承兑汇票怎么收费	您办理银行承兑汇票的收费标准“票面金额*0.04%+敞口金额*0.05%*期限。
怎么查询承兑汇票的真假	如果需要查询承兑汇票真假，您可以到您对公户开户行委托他们查询。
济宁银行的承兑汇票金额部分手写吗	我行签发的银行承兑汇票金额部分为手写，其他部分为机器打印。
银行承兑汇票贴现介绍	银行承兑汇票贴现是客户将所持有未到期的银行承兑汇票转让于我行，我行按票面金额扣除贴现利息后，将剩余资金付给客户的一种融资行为。我行在银行承兑汇票到期日直接向承兑银行提示付款收回票面金额。如果您需要办理银行承兑汇票贴现业务，为了您的业务能够尽快办理，建议直接与您的对公户开户行联系。
银行承兑汇票贴现特点	银行承兑汇票贴现特点：1.客户所持银行承兑汇票在到期日前可随时向我行申请贴现，无需提供其他任何形式担保，融资效率高； 2.贴现利率一般情况下较贷款利率低，客户可降低融资成本；3.客户在我行办理银行承兑汇票贴现，一般不占用客户在我行的信用额度；4.银行承兑汇票在我行一经贴现，我行将在到期日直接提示承兑银行付款。
如何办理承兑汇票的托收	办理银行承兑汇票托收业务需在我行开立结算账户，办理托收业务时需要提供银行承兑汇票和填写我行托收凭证，需携带预留印鉴章。
办理承兑汇票的托收是否收费	办理银行承兑汇票托收费用为23元。
银行承兑汇票骑缝章盖错	银行承兑汇票骑缝章加盖错误，需要由加盖错误的单位出具证明信。
银行承兑汇票过期是否使用	承兑汇票的有限期为6个月，过期将无法使用。
个人收到银行承兑汇票怎么使用	个人目前无法在我行办理承兑汇票业务。
承兑汇票的提示付款期限	自汇票到期日起10 天内（此处10天为自然日）。
超过汇票到期日了如何处理	如果超出汇票到期日10天，需要出具延期证明，延期证明应当写明延期的原因，以及“引起的经济纠纷自行承担”等内容。
负责承兑汇票的电话是多少	如果您想咨询我行签发的承兑汇票相关问题，您可以拨打票据中心电话0537-2216988或我行客服热线400-677-0537咨询。
什么是ATM	我行自助设备包括以下几种：1.自动取款机（ATM）主要有取款、转账、查询、改密等功能； 2.存取款一体机在ATM全部功能的基础上，还提供存款功能。
自助设备可以存钱吗	目前我行的存取款一体机可以实现活期存款和取款的功能。我行的自助取款机（简称ATM）可以实现活期取款的功能。
自助设备有哪些	目前我行有自动取款机（简称ATM）、存取款一体机等多种自助设备 。
为什么你们行的自助设备存不进去钱	自助设备无法存款可能是由于我行自助设备的存款箱已达到上限，短时间内无法再满足客户的存款需求；您可以选择附近我行其他的自助设备继续存款，感谢您的支持和理解。
自助设备出现故障	自助设备出现故障，请拨打我行客服电话400-677-0537咨询。
自助设备什么情况会发生退卡	自助设备退卡的情况有两种： 1.您自己选择退卡；2.您在设备设定的时间内没有操作（一般为30秒，不同类型设备的时间存在差异），设备自动退卡。
自助设备每天最多可以取多少钱	根据中国人民银行的规定，我行发行的人民币借记卡--儒商卡在国内自助设备上每日累计最多可取20000元人民币。国内其他银行发行的银行卡在我行自助设备每日取现额度遵从发卡银行规定。
我能在自助设备上打印明细吗	我行自助设备可查询银行卡的交易明细，但不能打印。
ATM转账功能申请	ATM转账是指我行借记卡客户通过我行任一ATM自助设备向其他账户进行资金划转，须您本人持有效身份证明、借记卡前往网点柜台办理。办理转账时，收款方可为任意银行的借记卡、结算存折或信用卡。
能在ATM上进行的操作都能在微信上操作么	亲，这个不一定哦......
ATM取款限额调整	我行儒商卡每日取款限额为20000元，你可以根据你的需要进行调整，但最高不得高于20000元。
ATM余额跟网上显示余额不一样	在ATM取款显示的是您卡片的活期可用资金，通过网上渠道还可以查询到您卡片的其他子账户（比如定期等），显示的余额不一致是正常的情况。若您要取现，以您看到的“活期余额”资金为准。
ATM转账到账时间	行内转账：实时到账；跨行转账：您转账成功之后，我行及时转出，具体到账时间由对方行的处理速度决定。
济宁银行卡在济宁银行ATM发生错账	出现存款未入账或取款未出钞的情况，若自助设备旁有网点请您立即与银行工作人员联系；若自助设备旁无网点或在营业时间外,请您立即致电400-677-0537咨询。此外，请确认设备已恢复广告页面且无其他异常后离开，若有异常请及时拨打400-677-0537。
在境内ATM可受理的币种	境内ATM目前仅受理人民币业务，若您有支取外币的需要，建议您联系柜台咨询一下兑换事宜。
济宁银行卡在境外ATM发生吞卡	如果您在境外使用ATM，当ATM发生故障、持卡人操作失误或忘记取卡造成吞卡时，请您及时与ATM机所属机构联系，确认领卡事宜；如无法领卡，请您及时拨打济宁银行客服热线400-677-0537人工挂失您的卡片，等您回国后办理挂失补卡。
ATM行内转账手续费	通过我行ATM自助办理我行行内转账无手续费。
他行卡在济宁银行ATM取款的手续费	其他银行卡在我行ATM机取款手续费由发卡银行规定，请联系发卡银行咨询。
ATM跨行转账手续费	我行儒商卡通过我行ATM自助办理我行跨行转账无手续费。
济宁银行卡在境外ATM取款限额	济宁银行借记卡在境外ATM取款，日累计取款不超过等值1万元人民币。
济宁银行卡在他行ATM发生错账	若是济宁银行卡片在他行ATM机器发生错账，由于此问题需要您的一些个人资料做纪录，为了账户安全，请您及时拨打400-677-0537，进入人工服务为您登记，后续为您核实处理。
哪里有atm	LB0101
pos如何办理	申请开办POS收单业务的商户必须从事实体经营且有固定的经营场所，并提供受理支行所需要的相关资料。建议您直接与您的对公户开户行联系或拨打我行客服电话400-677-0537咨询。
pos商户结算手续费率标准是多少	主要行业及商户类别的交易手续费扣率如下：1.宾馆、餐饮、娱乐、珠宝金饰、工艺美术品类的商户手续费为1.25%；2.一般类型的商户（零售行业）手续费为0.78%；3.房地产行业，汽车行业的商户手续费为单笔1.25%-80元；4.批发类的商户手续费为单笔0.78%-26元；5.民生类商户手续费为0.38%；6.公益类商户手续费按服务成本收取。
pos机具坏了，怎么维修	您可以根据商户号或者终端号判定为您的POS机具办理维修服务的第三方：:一、银联商务  商户号后四位0001顺序 终端号62000001顺序  电话2279119、95534。二、山东运达  商户号后四位2001顺序 终端号63000001顺序  电话3925733。三、通联商务  商户号后四位3001顺序 终端号40000001顺序  电话2107508。四、杉德      商户号后四位5001顺序 终端号20000001顺序  电话22225045.运通      商户号后四位8001顺序 终端号48000001顺序  电话3979555。
pos机如何操作使用	您在办理POS机业务时，相应公司会提供相应的培训。
pos特约商户资金清算时间是几天	在我行办理的POS商户清算资金入账的正常时间为交易日的下一个工作日，遇节假日顺延。
我是POS商户昨天的账还没到	POS商户入账时间是次个工作日。如果长时间没有到账，请拨打我行客服电话400-677-0537咨询。
POS机扣款但没有出小票	如果您为我行pos机商户，请您告知客户未打印小票代表交易未成功，可以要求客户再次刷卡或者交付现金；如果您是客户，未打印小票代表交易未成功，即使收到扣款短信，后期款项会冲正到卡内，建议您留意短信提醒或账户余额。
个人能办理pos机吗	目前我行无法办理个人pos机业务。申请POS收单业务需在我行开立对公结算账户并满足我行其他条件。建议您直接与您的对公户开户行联系或拨打我行客服电话400-677-0537咨询。
pos申请需要多长时间	在我行申请POS业务时间一般为自审核之日起7个工作日，封顶商户适当延长。
能安装移动的pos机吗	航空、餐饮、交通罚款、上门收费、移动售货、物流配送等确有使用移动POS需求的行业商户，对因经营地点因通讯公司网络布设等原因无法布设固定POS机具的，需要提供相关证明材料及受理支行所需的其他资料。
pos县乡优惠	根据国家相关政策，我行可以办理县乡优惠相关POS业务。建议您直接与支行网点联系或拨打我行客服电话400-677-0537咨询。
儒商卡在pos机刷卡消费的手续费	只要您持儒商卡在带有银联标志的POS机刷卡消费，我行不收取您的手续费。
预授权	如果您账户余额和可用金额不一致时，说明您预授权没有完成，在消费完成后，忘记预授权，该笔预授权会在30个工作日自动解除冻结。
贷款还款逾期了，对信用记录有影响吗	征信报告会显示您五年之内的征信情况，未按时还款可能会产生罚息并影响个人信用记录。因此如有逾期，建议您尽快联系贷款经办行核实后续处理流程，否则将有可能影响您之后的银行业务办理。
个人贷款逾期后如何还款	如您的贷款已经逾期，请尽快联系您的贷款经办网点，核实还款补交的方式。
申请个人贷款有年龄限制么	借款申请人年龄需在18周岁（含）以上，60周岁（含）以下。
个人贷款，需要什么条件	个人贷款申请人的基本条件：1.具有基本完全民事行为能力，年龄加贷款期限原则上不得超过60岁；2.具有稳定的收入来源，具备按期还本付息能力；3.个人及其配偶信用状况良好，在金融机构无重大不良信用记录；4.能够提供合法、足值的抵质押担保或经我行认可的有效保证担保；5.借款用途必须合法合规；6.贷款申请数额、期限币种合理；7.我行要求的其他条件。
个人贷款逾期还款是否会产生罚息	如需了解贷款逾期后的罚息情况，建议您查看贷款合同规定或联系贷款经办网点进行具体核实。
个人贷款什么情况下算逾期	扣息日或贷款到期日当天账户余额不足以偿还当期利息或贷款余额的情况即为逾期。
申请公积金贷款的要求	凡按时足额缴存住房公积金，并具有完全民事行为能力的职工，购买、建造、大修、翻建自住住房的，均可申请公积金贷款。
公积金贷款额度是多少	公积金贷款额度：1.购买商品房或经济适用房的，最高贷款额不得高于购房总价款的70%；购买二手房或单位集资所建房屋的，不得高于购房总价款的60%；2.贷款最高额度不得超过抵押物现有价值的70%；以有价证券作质押担保的，不得超过有价证券面值的90%，并以有价证券到期日为贷款期限；3.借款人的贷款额度按照借款人及共同借款人月收入情况确定。
申请个人消费贷款需要什么资料	申请个人消费贷款需要的资料：1.个人贷款申请表；2.身份证、户口簿、结婚证、借款人及其配偶的职业、收入证明；3.贷款用途的相关证明材料。
申请个人经营贷款需要什么资料	申请个人经营贷款需要的资料：1.身份证明文件、户口本、结婚证；2.营业执照、特殊行业经营许可证；3.房产证、土地证及其他证明文件；4.银行对账单、纳税凭证；5.其他需要提供的材料。
需要贷款应到哪家网点办理	我各支行网点均可受理贷款产品业务。如申请小微贷款产品可通过拔打我行客服热线400-677-0537人工查询就近小微信贷中心位置。
申请通过的贷款什么时候放款	如需查询放款时间，您可在与我行签订的贷款合同中查询。此外，您还可联系贷款经办网点进行查询。
申请公司类贷款，需要什么条件	申请公司类贷款的基本条件：1.恪守信用，有按期还本付息的能力；2.已在当地工商行政机关办理年检手续；3.在我行开立基本账户或一般存款账户；4.有限责任公司和股份有限公司对外股本权益性投资累计不超过净资产的50%；5.资产负债率符合贷款人的要求；6.申请中长期贷款，新建项目的企业法人所有者权益与所需总投资的比例不低于国家规定的投资项目的资本金比例。
申请公司类贷款时应提供哪些资料	申请公司类贷款需要的资料：1.借款申请书；2.经过年检的营业执照、组织机构代码证、贷款卡、税务登记证；3.公司章程、验资报告；4.上一年度和最新一期财务报表及生产经营、物资材料供应、产品销售有关统计资料；5.特殊行业的还需要提供特种经营许可证等有关资质证明； 6.客户在银行开立基本账户情况和原有借款还本付息情况；7.购销合同复印件或反映资金需求的有关凭证资料；8.银行需要的其他资料。
贷款担保人应提供哪些材料	贷款保证担保，保证人应提供的担保资料，与借款人相同。
下岗再就业贷款，需要什么条件	下岗再就业贷款的基本条件：1.借款申请人为持有劳动保障部门颁发的《再就业优惠证》人员，身体健康，诚实守信，有一定劳动技能和固定住所，年龄加贷款期限不超过60。2.借款申请人需有具体的经营项目，且自筹资金不足的，方可提出贷款申请。3.借款申请必须经劳动保障部门进行资格认定，取得担保机构的担保承诺，并提供本行认可的担保。4.下岗失业人员申请借款应按属地管理原则，由所在社区和劳动保障部门组织进行。
贷款还款日是几号	每月20日为贷款还款日，由系统自动从贷款账户中扣收。
什么是微贷宝	微贷宝是济宁银行引进国际先进贷款技术进行本土化改造推出的一项全新贷款业务品种，专门为个体工商户、小微企业主提供5千元至50万元的资金支持。以专业化的信贷团队，标准化的服务流程，让客户在3—5个工作日即可获得贷款的机会。
微贷宝系列产品	微贷宝系列产品包括：1.“速贷通”贷款；2.“商贸通”贷款；3.“路路通”贷款；4.“惠农宝”贷款；5.“工贸通”贷款。
什么是出租车速贷通贷款	出租车速贷通贷款为经营出租车期限三个月以上更新车辆及购买营运证的客户设计，贷款期限为3个月到3年，贷款额度5000元至15万元（更新车辆最多支持购车金额的70%，购买营运证最多支持30%）还款方式建议为按月等额本息还款。
什么是商贸通贷款	商贸通贷款为从事商业贸易流通类经营期限超过3个月以上的个体工商户、小微企业设计，贷款期限为3个月到2年，贷款额度5000元至50万，建议采用按月等额本息还款、按月还息按季还本等灵活还款方式。
什么是路路通贷款	路路通贷款为运营客运、货运车辆三个月以上，更新车辆的客户设计，贷款期限为3个月到2年，贷款额度5000元至50万，还款方式建议为按月等额本息还款。
什么是惠农宝贷款	惠农宝贷款为经营期限两年且至少两个养/种植周期农业养殖、种植类等的农户、小微企业设计，贷款期限为3个月到2年，贷款额度5000元至50万，还款方式根据客户种养殖的对象以及客户的实际种养殖情况决定。
什么是工贸通贷款	工贸通贷款为从事工业贸易、生产加工类经营期限超过3个月以上的个体工商户、小微企业设计，贷款期限为3个月到2年，贷款额度5000元至50万，还款方式建议为按月等额本息还款、按月还息按季还本还款。
公积金贷款利率是多少	公积金贷款利率按照中国人民银行和市住房公积金管理中心有关规定执行。
小微企业贷款需要什么条件	小微企业贷款基本条件：1.贷款额度在十万元以下，经营生意且经营生意期限满三个月，要求找一个年收入为申请人申请金额一半的担保人。2.贷款额度在十万元或者十万元以上，经营生意要求满一年。要求找一个年收入为申请人申请金额一半的担保人且担保人需要有一套房产。
小微企业贷款利率是多少	按照不同风险、不同经营方式等条件，实行差别利率，若想查询小微企业贷款利率建议您在办理时具体询问支行。
小微企业贷款期限是多长时间	小微企业贷款三种信贷模式：1.用于流动资金投资的：贷款期限为三个月至一年；2.用于固定资产投资的：贷款期限为三个月至两年；3.用于出租车购买的：贷款期限为三个月至三年。
小微企业贷款还款方式有几种	还款小微企业贷款，建议您使用按月等额还本付息法，但可以根据您的实际生意情况制定灵活的还款计划表。
小微企业贷款贷款额度是多少	小微企业贷款额度为5000元到50万。
出租车贷款申请流程	出租车贷款申请流程：1.带上您的身份证、出租车营运资质证明材料（营运证、驾驶证、行驶证、挂靠合同或承包协议）；2.如实告知您的生意状况；3.我们通过实地调查分析；4.审贷会作出决定后第一时间通知您。
申请的小微贷款什么时候放款	小微贷款申请后3-5个工作日给与明确答复。
为什么我的贷款申请失败了	我行严格按照银监局和人民银行的要求，实行贷款审批程序。如需核实贷款申请失败的具体原因，建议您直接联系您的贷款申请网点查询。
个人公积金贷款提前还款流程	公积金贷款相关制度由住房公积金管理中心制定。建议您联系公积金管理中心或贷款经办网点核实个人公积金贷款提前还款流程。
小微贷款的优势是什么	小微贷款的优势：1.申请门槛低，5000元即可申请，最高可达50万元；2.手续简便，只需提供身份证、营业执照等基本资料，真实反映生意情况；3.贷款无需提供抵押，只需提供担保；4.期限灵活，最低3个月，最长可达2年；5.申请用途广泛，只要是生产、经营等正当用途，均可申请；6.调查审批快速，一般3-5个工作日内即可给予答复；7.可自主选择还款方式，每月分期还款。
小微贷款申请流程	小微贷款申请流程：1.带上您的身份证到我行网点；2.如实告知您的生意状况；3.我们通过实地调查分析；4.审贷会作出决定后第一时间通知您。详情咨询小微中心0537-2896509或拨打我行客服热线400-677-0537
怎么提前还贷款	因各分行贷款业务存在差异，请联系您的贷款经办网点具体咨询提前还贷流程。
贷款利率	WX0145
短信通知业务怎么开通	如果您是企业用户，开通短信提醒业务需要企业客户需由企业经办人携带本人身份证原件、企业身份证明材料及企业法人授权委托书（法定代表人本人办理时不需要），至账户开户网点签约办理。如果您是个人客户，开通短信通知业务有以下几种方式：1.如办理网上银行可以通过网上银点击【服务申请】—【动账短信服务定制】开通；2.您可以携带银行卡、有效身份证件至柜面开通；3.如果您办理手机银行业务可以点击【客户服务】—【短信通知签约】开通业务。
短信通知业务收费么	短信提醒业务是免费的，开通免费，使用同样免费哦～
短信通知号码怎么修改	企业用户修改短信通知号码需要到对公户开户网点办理。个人客户修改短信提醒的号码有以下几种方式:1.如办理网上银行可以通过网上银行点击【客户服务】—【通知提醒服务】修改；2.如果您办理手机银行业务可以点击【服务申请】—【动账短信服务定制】修改；3.本人携带银行卡、有效身份证件至柜面修改；4.拨打400-677-0537进行修改。
收不到短信提醒怎么办	您收不到短信提醒可能有以下几种状况：1.首先判断有无开通短信提醒的业务；2.可能因运营商业务量大、信号干扰等问题影响了短信的接收；3.判断是否因为手机安装屏蔽短信的客户端；4.查看手机是否遇到停机、收件箱满等手机功能的问题；5.以上方式您都试过后可以换个手机试一试；6.若连续多笔短信接收异常可拨打400-677-0537进行记录排查。
什么时候会给我发短信提醒	只要您签约短信提醒业务，并且卡内的余额发送变动就会给您发送动帐服务短信。
收到不是我的短信提醒	如果收到不是您本人的提醒短信，请您按照以下步骤排查：1.首先请您判断是不是由济宁银行给您发送的短信，济宁银行唯一的短信服务平台号码是10690333070537；2.如确定收到短信为该号码，您需要判断的是有没有在济宁银行有过贷款或者担保；3.请您核实是否您的家人、朋友在银行预留了您的手机号，也可能是其他客户在办理业务时留错号码或是以前曾使用过该号码。您也可以致电我行客服热线400-677-0537进行咨询处理。
短信通知的开通有什么限制么	目前全国移动、联通、电信的客户均可以开通短信提醒业务。
给我发送短信通知号码是多少	济宁银行唯一短信服务号码是10690329150537。
怎么关闭短信提醒	如果您是企业用户，关闭短信通知号码需要到对公户开户网点办理。如果您是个人客户，关闭短信通知业务有以下方式：1.使用开通业务手机发送短信DXJY+账号后四位（输入时不需要“+”号）至10690333070537可自行关闭；2.如办理网上银行可以通过网银点击【服务申请】—【动账短信服务定制】关闭；3.如果您办理手机银行业务可以点击【客户服务】-【短信通知签约】关闭；4.可以本人携带银行卡、有效身份证件至柜面办理；5.拨打400-677-0537我行客服电话关闭业务。
短信通知有什么用	短信通知是通过向您的手机发送短信的方式与您实现信息沟通，向您提供交易通知、业务提醒、账户查询等各项金融服务，以及我行业务宣传和业务应急通知等通知服务；另外您可以发送短信实现查询余额、查询账户明细（最近3笔）、短信业务解约（仅限个人客户）。具体查询方式可以回复任意键至10690329150537获取.
短信通知服务的手机号如何修改	您好，修改短信通知服务的手机号需要您先登录网上银行，进到签约模块查看已签约的情况，选择账号点击详情，进入修改页面，对手机号码进行修改。其中，只有签约动账短信后的账号才可以用网上银行修改签约手机号码功能。网上银行修改动账短信手机号码时需要验证手机号码有效性和网银认证方式。
如何签约动账短信业务	您好，签约动账短信业务需要您先登录网上银行，选择签约功能，选择短信进行开启，进入短信开启页。
网上银行开通动账短信最多选择多少手机号码	您好，网上银行开通动账短信手机号码只可开通一个。
开通动账短信需要验证什么	您好，网上银行开通动账短信需要验证手机号码有效性和网银认证方式。
签约动账短信后什么时候收到短信	您好，网上银行开通动账短信成功后，当用户的余额发生变动时，会发送通知短信。
关闭动账短信后还会有动账提醒吗	您好，网上银行关闭动账短信服务后，当用户卡内的资金产生变动时不会再通知用户。
关闭动账短信的认证方式	您好，网上银行关闭动账短信的认证方式：一代U-key：U-key+PIN码二代U-key：U-key＋PIN码，令牌：令牌+挑战码。
解约动账短信需要验证哪些信息	您好，网上银行解约动账短信是需要验证U-key或令牌认证方式。
如何开通一代uk短信验证服务	您好，如果您是一代U-KEY客户，请登录网上银行，进入设置—安全中心，开通短信验证服务。
什么是网上银行短信验证服务	您好，网上银行短信验证服务是指为个人网上银行客户提供的，客户在使用Ukey进行交易确认过程中，用手机短信辅助验证的一种交易确认方式。当用户不需要该功能时可以关闭该服务。
开通短信验证需要验证什么	您好，网上银行开通短信验证时，需要验证手机号码有效性，手机号须为网银预留手机号，核心预留手机号，动账短信手机号码其一，同意短信验证服务条款，认证方式。
网上银行开通短信验证的业务规则	您好，网上银行开通短信验证的业务：1.有撤销后的账号才可以做开通操作，只要开通了一代u-key的用户可以使用该功能。2.设置的起始金额给出默认金额。3.开通成功后，该用户名下的所有卡的金额交易都需要短信验证。
网上银行如何关闭短信验证服务	您好，关闭短信验证服务首先请您进入网银设置模块，点击安全中心查看开通情况，点击关闭按钮。
网上银行关闭短信验证的业务规则	您好，网上银行关闭短信验证的业务规则：1.只有开通后的账号才可以做关闭操作。2.关闭该功能时验证用户认证方式。3.关闭该功能后，该用户名下的所有卡的金额交易都受该业务影响，进行交易时不再发送短信验证码验证。
网上银行关闭短信验证的认证方式	您好，网上银行关闭短信验证的认证方式：一代U-key+短信验证码。
网上银行修改验证短信的起始金额	您好，修改验证短信的起始金额请您先登录网上银行，进入网银设置模块，点击安全中心查看开通情况，点击金额设置功能。
网上银行修改验证短信的起始金额的用途	您好，网上银行修改验证短信的起始金额可以让用户主动掌控账户的安全性。
网上银行修改验证短信起始金额的业务规则	您好，网上银行修改验证短信起始金额的业务规则：1.只有开通服务后才可以做修改起始金额操作。2.修改时，需要验证手机短信验证码。3.设置的起始金额给出默认金额。
短信通知服务如何开通	您好，开通短信通知服务需要您先登录网上银行，选择签约功能，选择短信进行开启，进入短信开启页。
短信通知服务如何关闭	您好，关闭短信通知服务需要您先登录网上银行，选择签约功能，选择短信进行关闭，进入短信关闭页。
定活两便储蓄存款定义	定活两便储蓄存款是一种不确定存款期限，利率随存期长短而变动的储蓄存款。
定活两便储蓄存款的特点	定活两便储蓄存款的特点为：1.存取灵活，流动性较好；2.可质押贷款。
定活两便储蓄存款办理流程	办理定活两便储蓄存款，需要您持本人有效身份证件到我行任一网点办理。如委托他人代办开户，还需同时出示代理人身份证件。
定活两便的起存金额	定活两便存款50元起存，没有上限。
定活两便的利息计算	定活两便的利息计算方式：1.存期不满三个月的，按支取日挂牌公告的活期利率天数计付活期利息；2.存期三个月以上(含三个月)，不满半年的，整个存期按支取日挂牌公告的定期整存整取三个月存款利率打六折计息；3.存期半年以上(含半年)，不满一年的，整个存期按支取日挂牌公告的定期整存整取半年期存款利率打六折计息；4.存期在一年以上(含一年)，无论存期多长，整个存期一律按支取日定期整存整取一年期存款利率打六折计息。
定活两便的支取如何办理	您可持已设密码的存单在我行任一网点，对定活两便储蓄存款进行支取，但当日存、当日取的定活两便储蓄存款应到开户行支取。
教育储蓄开立的对象	教育储蓄开户对象是在校小学四年级（含四年级）以上的学生；接受非义务教育的在校全日制高中、大中专、大学本科、硕士和博士研究生。
教育储蓄如何支取	教育储蓄支取方式：1.到期支取时，需凭存折及学校提供的正在接受非义务教育的学生身份证明（以下简称“证明”）一次支取本金和利息，享受国家规定的教育储蓄优惠利率，并免征教育储蓄存款利息。一份“证明”只能享受一次利率优惠。不能提供“证明”的，按实际存期和开户日挂牌公告的同期同档次零存整取储蓄存款利率计付利息；2.提前支取时，储户能提供“证明”的，按实际存期和开户日挂牌公告的同档次整存整取储蓄存款利率计付利息，并免征教育储蓄存款利息所得税。不能提供“证明”的，一律按实际存期和支取日挂牌公告的活期储蓄存款利率计付利息；3.存款逾期部分，按支取日挂牌公告的活期储蓄存款利率计付利息。
教育储蓄起存金额是多少	教育储蓄最低起存金额为：50元人民币。最高限额：每一账户本金合计最高限额为2万。
什么是教育储蓄	教育储蓄是指开户时约定存期，本金分次存入，到期时储户凭存折及学校提供的正在接受非义务教育的学生证明（必须是当年有效证明，且一份证明只能享受一次利率优惠）一次支取本息，并免征储蓄存款利息所得税的一种储蓄存款方式。
教育储蓄可以存多久	教育储蓄存期为一年、三年、五年。
教育储蓄最高限额是多少	教育储蓄最低起存金额为：50元人民币。最高限额：每一账户本金合计最高限额为2万。
教育储蓄如何开户	教育储蓄开户时采取实名制，需持储户本人（学生）户口簿或居民身份证到济宁银行任一网点以储户本人（学生）的姓名开立存款账户。
教育储蓄存款方式	教育储蓄存款，开户时储户应与银行约定每月固定存入的金额，分次存入，途中如有漏存，应在次月补存；未补存者视同违约，对违约后存入部分视同活期存款管理。
七天通知存款	七天通知存款必须提前七天通知约定支取存款。
一天通知存款	一天通知存款必须提前一天通知约定支取存款。
通知存款的定义	通知存款是一种不约定存期，支取时需提前通知金融机构，约定支取存款日期和金额的储蓄存款。
通知存款的起存金额	通知存款起存金额个人为5万元，单位为50万元。
通知存款种类利率	通知存款种类：1.一天通知存款：提前一天通知约定支取存款，年利率0.96%。2.七天通知存款：提前七天通知约定支取存款，年利率1.62%。
个人通知存款的提前支取	如提前支取通知存款，所支取的部分，将按活期存款利率计算利息。
个人通知存款的支取	如想支取通知存款请在预约到期日，携带本人有效证件和相关存款单据，到营业网点办理提款手续。
通知存款能否自动转存	七天通知存款可支持自动转存，一天通知存款不支持。
个人通知存款的预约转存	您可根据需要设置通知存款预约转存功能。
通知存款的利息计算	通知存款计息方式如下：1.通知存款按支取日挂牌公告的相应利率和实际存期计息，利随本清。2.实际存期不足通知期的，支取部分按活期存款利率计息。3.未提前通知而支取的，支取部分按活期存款利率计息。4.支取金额不足最低支取金额的，按活期存款利率计息。5.支取金额不足或超过约定金额的，不足或超过部分按活期存款利率计息。6.已办理通知手续而提前或逾期支取的，支取部分按活期存款利率计息。7.已办理通知手续而不支取或在通知期内取消通知的，通知期内不计息。
个人通知存款的部分支取	部分提取通知存款时，每次提取的金额应大于通知存款的最低起存金额（人民币5万元（含））。
通知存款如何办理	若您想办理通知存款，您可以进入我行手机银行、电话银行或网上银行，根据提示进行通知存款的开户；或本人持有效身份证件、账户到我行任一网点办理。
零存整取的定义	零存整取是指开户时约定存期，金额自定，每月固定存入一次，中途如有漏存，应在次月补存，到期一次支取本息的储蓄存款。
零存整取起存金额	零存整取开立起存金额最小为5元人民币。
零存整取续存日期	零存整取需每月手动操作续存，自然月当月任一天续存都可以。
零存整取利息计算	零存整取按您存入日计算利息。
零存整取漏存或违约规定	零存整取中途如有漏存，应在次月补齐，未补存者，视同违约，对违约后存入的部分，支取时按活期利率计息。
零存整取的利率是多少	零存整取的利率：一年期的年利率为2.82%，三年期的年利率为3.06%，五年期的年利率为3.30%
零存整取如何办理	若您想办理零存整取，您可以进入我行电话银行或网上银行等电子渠道，根据提示进行零存整取的开户；或本人持有效身份证件、账户到我行任一网点办理。
零存整取支取	零存整取到期后逾期部分按活期利率计息，可通过我行网上银行或任一网点办理支取；未到期提前支取，您需要持本人有效身份证件、账户到任一网点办理，支取后按活期计息。
整存整取的定义	整存整取是指在存款是约定存期，本金一次存入，全部或部分支取本金和利息的服务。
整存整取的特点	整存整取的特点为：利率较高；可约定转存；可质押贷款；可提前支取。
济宁银行整存整取的年利率	济宁银行整存整取年利率为：1.三个月定期存款2.82%2.六个月定期存款3.06%3.一年期定期存款3.30%4.两年期定期存款4.02%5.三年期定期存款4.8%6.五年期定期存款5.225%
整存整取如何办理	若您想办理整存整取，您可以进入我行手机银行、电话银行或网上银行，根据提示进行整存整取的开户；或本人持有效身份证件、账户到我行任一网点办理整存整取存款。
整存整取转存方式	您在开立整存整取账户时，可选择“到期自动转存”，整存整取账户到期后，我行系统就将此账户连本带息自动转存成相同期限的整存整取；如果您没有选择“到期自动转存”，整存整取账户到期后则自动按活期计息，但无法自动转成活期。
整存整取支取如何办理	请持定期存单或一本通或儒商卡到营业网点即可办理取款，如果取款金额超过5万（含5万），必须至少提前一天与取款网点预约。
整存整取提前支取如何办理	整存整取未到期支取，需要您本人持身份证、账户到我行任一网点办理提前支取。
整存整取可以存的币种	整存整取可以受理人民币和外币存款，外币指的是分行受理的外币币种。目前，现汇项下我行可以办理美元、港币、日元、欧元和英镑五个币种的个人外汇储蓄业务。现钞项下可以办理美元、港币、日元和欧元四个币种的个人外汇储蓄业务。起存金额：人民币为50元，外币为不低于50元人民币的等值外币。
整存整取的起存金额	整存整取起存金额：人民币为50元，外币为不低于50元人民币的等值外币。
整存整取的利息计算	整存整取定期存款按逐笔计息法中对年对月对日的计息公式计算利息。计息公式如下：1.计息期为整年（月）的，计息公式为：利息=本金*年（月）数*年（月）利率；2.计息期有整年（月）又有零头天数的，计息公式为：利息=本金*年（月）数*年（月）利率＋本金*零头天数*日利率。例如客户于2012年1月1日开1万元一年期整存整取账户，2013年1月1日支取，应得利息=10000*1*3.30%＝330元（案例中整存整取利率仅供参考）。
存折口头挂失如何取消	如果您办理存折口头挂失后找到了存折，需要本人持有效身份证件、存折在我行任一网点办理口挂解除。支取方式为“凭存折支取”的存折只能在开户行办理。
存折口头挂失办理流程	如果您的存折丢失，请尽快办理口头挂失。需要您持本人有效身份证件到任一网点办理；或拨打我行客服电话400-677-0537办理口头挂失。支取方式为“凭存折支取”的存折只能在开户行办理。
存折书面挂失如何取消	如果您办理存折书面挂失后找到了存折，需要本人持有效身份证件、挂失/换卡申请书、取消挂失的存折回办理行办理取消。
存折补登的定义	存折补登是指有时候在办理一些无折交易，因为不能在存折上作实时打印记录，存折有时并不能反映全部交易记录，因此交易记录以银行账户记录为准。当储户持存折办理业务时，未能实时打印的记录就会在此笔交易记录打印同时自动补登在存折上，或者银行工作人员选择补登打印交易也会把未实时打印的记录补登。
存折丢失补办流程	如果您的存折丢失，需要尽快办理口头挂失。然后持有效身份证件到开户行办理书面挂失。
存折满页后换折是否需要身份证	存折满页后换折，客户只需提供旧存折及存折密码即可办理换发新折。
定期一本通挂失流程	如果您的定期一本通丢失，请尽快办理口头挂失。需要您持本人有效身份证件到任一网点办理。支取方式为“凭存折支取”的存折只能在开户行办理。
什么是电话银行	电话银行业务是指我行使用计算机电话集成技术，通过电话自助语音和人工服务方式为客户提供的24小时不间断的金融服务。
个人电话银行的功能	我行个人电话银行为您提供账户查询、人工服务、转账服务、修改密码、口头挂失、明细传真、自助缴费、信息查询等服务。
企业电话银行的功能	企业电话银行为您提供账户查询、人工服务、修改密码、明细传真、信息查询等服务。
个人电话银行怎么签约	签约我行电话银行：1.开通查询功能：1.（1）本人持有效身份证件、儒商卡/存折到我行任一网点申请签约，设置查询密码，开通电话银行查询功能；1.（2）拨打400-677-0537，输入您账号、证件号，验证交易密码后，再设置查询密码，或直接转人工开通电话银行查询功能。2.开通转账功能：本人持有效身份证件、儒商卡/存折到我行任一网点申请签约，设置查询密码，开通电话银行查询、行内转账及缴费功能。
企业电话银行怎么签约	企业电话银行签约，您需要持：1.组织机构代码证正本原件2.预留印鉴3.法人身份证原件及法人授权委托书（法定代表人本人办理时不需要）4.经办人身份证原件及复印件5.到您的账户开户行办理。开通后，您可以进行账户查询类交易。
如何使用电话银行	使用我行电话银行，请拨打我行全国统一客服电话400-677-0537
拨打电话银行怎么收费	拨打我行电话银行400-677-0537我行不会收取任何服务费用；您只需按通话时间向当地通讯公司支付普通市话费。
电话银行签约的费用	签约我行电话银行暂不收取您的费用。
电话银行转账限额是多少	电话银行转账单笔限额及日限额均为5万元。
电话银行如何转账	我行电话银行现支持行内转账，需要您本人持有效身份证件、账户到我行任一网点柜面签约后，拨打400-677-0537根据语音提示选择您要办理的转账业务。大体流程为：选择1.个人业务—3.转账业务
电话银行如何缴费	我行电话银行支持联通手机号、联通固话、联通宽带号的自助缴费，需要您本人持有效身份证件、账户到我行任一网点签约后，拨打400-677-0537根据语音提示选择您要办理的缴费业务。大体流程：选择1.个人业务—8.缴费业务
电话银行如何挂失	通过拨打电话银行，您有两种方式进行挂失：1.选择3键“紧急挂失”，即可根据提示输入相应信息对您的账户或手机银行卡进行挂失；2.也可通过转人工，根据人工坐席提示进行挂失。
电话银行如何重置查询密码	通过拨打电话银行，您有两种方式重置查询密码：1.如果您忘记了电话银行查询密码，应及时携带本人有效身份证件及签约账户，到我行任一网点办理密码重置；2.也可通过电话银行进行查询密码重置。
电话银行如何修改支付密码	通过拨打电话银行，您有两种方式修改支付密码：1.选择4密码服务后，再选择3交易密码修改，即可根据提示修改密码；2.也可通过转人工，根据人工坐席提示修改密码。
电话银行如何修改短信通知号码	通过拨打电话银行，您有两种方式修改短信通知号码：1.选择1个人业务后，再选择7短信通知业务，即可根据提示修改号码；2.也可通过转人工，根据人工坐席提示修改号码。
个人电话银行怎么解约	您有两种方式进行个人电话银行解约：1.本人持有效身份证件、签约账户到我行任一网点申请解约；2.也可通过转人工，根据人工坐席提示解约电话银行；3.也可通过“1.个人业务-6.账户管理-3.删除签约账户”解约。
企业电话银行怎么解约	企业电话银行解约，您需要持：1.组织机构代码证正本原件；2.预留印鉴；3.法人身份证原件及法人授权委托书（法定代表人本人办理时不需要）；4.经办人身份证原件及复印件；5.到您的账户开户行办理。开通后，您可以进行账户查询类交易。
外汇现钞存入限额是多少	外汇现钞存入限额：如果您存入等值5000美元（含）以下可直接办理，高于等值5000美元凭本人有效身份证件、经海关签章的申报单或原存款银行外币现钞提取单据办理。
外汇现钞提取限额是多少	外汇现钞提取限额为单日提取等值1万美元（含）以下可直接办理，高于等值1万美元凭本人有效身份证件、提钞用途等证明材料向当地外汇局事前报备，再凭个人有效身份证件和经外汇局签章的提取外币现钞备案表办理提取手续。
我把外币换成人民币的限额是多少	个人结汇年度总额等值5万美元。
我用人民币换外币的限额是多少	个人购汇年度总额等值5万美元。
境内个人外汇储蓄账户汇出的限额是多少	境内个人外汇储蓄账户汇出单日等值5万美元（含）以下可直接办理。
境内个人外汇现钞汇出的限额是多少	境内个人外汇现钞汇出单日等值1万美元（含）以下可直接办理。
境外个人外汇储蓄账户汇出限额是多少	我行对境外个人外汇储蓄账户汇出无限额设置。
境外外汇现钞汇出限额是多少	境外外汇现钞汇出单日等值1万美元（含）以下可直接办理。
携带外币现钞入境限额是多少	如果您需要携带外币现钞入境：1.您携带外币现钞入境，等值5000美元（含）以下可直接办理；2.如果您携入等值5000美元以上需向海关办理申报。
携带外币现钞出境限额是多少	如果您需要携带外币现钞出境：1.您携带外币现钞出境，等值5000美元（含）以下可直接办理；2.您携出等值5000美元至1万美元，应向我行申领携带证；3.如果您携带等值1万美元以上出境的，需向当地外汇局申领携带证。
如何开立外币现钞账户	按照外管政策要求，外币现钞账户仅针对个人开立,只要持有在我行营业部开立的儒商卡即可直接办理外币存入业务，无需重复办理独立的外币账户开立手续。
如已有我行儒商卡，是否需要在营业部重新开卡	目前在我行，只要持有在我行营业部开立的儒商卡即可直接办理外币存入业务，无需重复办理独立的外币账户开立手续。
存入外币现钞是否可以代办	存入外币现钞按照规定可以委托他人办理，委托他人办理的除提供账户所有人的身份证外，还要提供代理人身份证件。
可以受理外币现钞业务和现汇业务的网点	1.对公外币业务我行下属分支行均可受理。2.个人外币现钞目前只有总行营业部可以办理，个人现汇业务总行营业部、菏泽分行、淄博分行、枣庄分行、泰安分行可以办理。
开立外币现汇账户需要什么条件	经有权管理部门核准或备案具有涉外经营权或有经常项目、资本项目外汇收入的境内机构（含外商投资企业）、境外机构、个人均可开立外币现汇账户。
申领携带证，需要提供的资料是什么	在我行申领携带证，需要提供的资料：1.护照或往来港澳通行证、往来台湾通行证；2.有效签证或签注；3.存款证明或相关购汇凭证；4.如从直系亲属外汇存款中提取外币现钞的，还应提供亲属关系证明。
什么是保函备用信用证业务	保函是指我行应客户（申请人）要求对外开立的具有担保性质的书面承诺文件，一旦申请人未按其与受益人签订的合同约定偿还债务或履行约定义务时，由银行履行担保责任。保函的种类包括投标保函、履约保函和预付款保函等。
什么是提货担保业务	提货担保是指我行根据客户要求，开立信用证后，在进口货物先于承运货物提单到达时，为客户先行提货而向承运人（船公司或其他运输公司）出具的书面保证书。
提货担保业务办理流程	提货担保业务办理流程：1.由您填写《提货担保申请书》并提交提单、商业发票、装箱单等单据副本；2.我行出具《提货担保书》，客户凭以办理提货手续；3.正本提单到达后，需要您及时用正本提单向运输公司换回我行出具的《提货担保书》。
什么是出口跟单托收	出口跟单托收是指我行根据您的指示，将您提交的出口单据寄交境外代收行委托收汇的结算业务。按交单方式不同分为付款交单（D/P）和承兑交单（D/A）两种方式。
出口跟单托收办理流程	出口跟单托收办理流程：1.需要您填写《出口托收委托书》，明确托收方式，并提交相应的单据。 　　2.我行向客户指定的国外代收行寄单。3.托收项下收汇，我行及时通知客户并办理入账、结汇。
什么是出口信用证	出口信用证是指我行作为出口方银行，对以客户为受益人的信用证办理的信用证通知、转通知、议付、转让等业务。
出口信用证业务流程	出口信用证业务流程:1.客户将我行开证路线提供给国外客户；2.收到国外来证后,我行及时审核信用证并通知您；3.需要您申请向我行交单、融资；4.出口信用证收汇、归还融资。
什么是光票托收	光票托收是指企业或个人将从国外收到的清算票据（银行汇票、本票、支票）委托我行向境外收款的结算业务。
光票托收业务办理流程	光票托收业务办理流程：1.客户在收到国外的各类票据后，在票据背面背书（盖财务章或带身份证原件并经有关人员签字）后，可向我行提出托收申请；2.我行将根据票据的种类、币别、金额、付款地区、收款人资信情况，提醒您选择“立即贷记”、“收妥贷记”或“安全托收”等托收方式。
什么是进口代收业务	进口代收业务是指我行收到国外托收行寄交的托收单据后，向您提示单据，并要求您付款赎单或承兑赎单的结算方式。
进口代收业务办理流程	进口代收业务办理流程为：1.需要您将我行的收单地址通知境外客户；2.进口代收项下到单后，我行及时通知您；3.根据赎单条件，需要您付款赎单或承兑赎单。
什么是代客外汇买卖	代客外汇买卖是指我行为满足您调整外汇资产币别结构、规避汇率风险、降低汇兑成本而提供的不同币种间的外汇买卖业务。
什么是出口托收押汇	出口托收押汇是指采用托收结算方式的客户（出口商），在提交单据、委托我行向进口商收取款项的同时，要求我行先预支部分或全部货款，待托收款项收汇后归还我行融资的业务。
出口信用证押汇/贴现业务流程	出口信用证押汇/贴现业务流程：1.需要您向我行提交《出口押汇/贴现申请书》；2.我行会为您审核提交的单据，根据不同情况支用境外银行金融机构额度或您的授信额度后为您发放出口押汇或贴现款项；3.出口收汇后，偿还出口押汇或出口贴现融资。
什么是打包贷款	打包贷款是指我行根据您的要求，将以您为受益人的正本信用证留存，在提交单据前向其发放的用于该信用证项下备货的专用贷款。
打包贷款业务办理流程	打包贷款业务办理流程：1.需要您提供《打包贷款申请书》、出口合同等资料；2.我行审批，融资入账；3.装船发货，向我行交单；4.出口收汇后，归还打包贷款。
什么是订单融资	订单融资也称作非信用证项下打包贷款，是指汇款和跟单托收方式下，出口商凭符合条件的出口合同或订单向我行申请的用于出口货物备料、生产和装运等履约活动的短期贸易融资。
订单融资业务办理流程	订单融资业务办理流程:1.需要您提出申请，提交《订单融资业务申请书》、出口合同或订单等；2.由我行审批，融资入账；3.申请人备货、生产、发货；4.出口收汇后，归还我行融资。
什么是进口代付	进口代付是指在进口业务项下，我行根据会根据您的申请，指示代付行先行支付进口项下货款，在融资到期日，您需要将融资本息归还我行，我行归还代付行的短期贸易融资。
进口代付业务办理流程	进口代付业务办理流程：1.需要您提交《进口代付申请书》及相关单证资料，并签署《信托收据》；2.我行审批，指示代付行支付款项；3.代付到期，需要您归还我行融资，我行向代付行还款。
什么是进口开证业务	进口开证是指我行根据客户（申请人）的要求和指示，向受益人（出口商）开具的在规定的期限内、凭规定的单据支付一定金额的书面承诺。
进口开证办理流程	进口开证业务办理流程：1.需要您填写《跟单信用证开立申请书》，并提交进口合同等相关资料；2.我行审批，对外开证；3.进口到单。即期信用证项下，由您付款赎单；远期信用证项下，由您承兑赎单；4.远期信用证承兑到期，由您付款。
什么是出口商业发票融资业务	出口商业发票融资业务是指客户（出口商）采用赊销(O/A)、承兑交单(D/A)等信用方式向进口商销售货物或提供服务时,在按照合同规定出运货物或提供服务后,将出口商业发票项下应收账款债权转让与我行,向我行申请的资金融通业务。
出口商业发票融资业务办理流程	出口商业发票融资业务办理流程：1.需要您提出申请，并提交出口合同、发票、报关单等材料；2.我行审批、放款；3.对外寄单；4.出口收汇后，归还我行融资。
什么是进口押汇	进口押汇是指我行根据您的要求，在您提交《信托收据》的前提下，为您对外支付货款所提供的短期贸易融资。
进口押汇业务的办理流程	进口押汇业务办理流程：1.需要您填写《进口押汇申请书》，签署《信托收据》。货到汇款项下还需提供运输单据、正本进口货物报关单等资料；2.我行审批，融资入账；3.融资到期，需要您归还我行进口押汇。
单位外汇储蓄起存限额是多少	单位外汇储蓄起存限额为：1.单位活期存款起存额为不低于1000元人民币的等值外币。2.单位定期存款分为一个月、三个月、六个月、一年和两年等五个档次，起存金额为不低于10000元人民币的等值外币。3.单位通知存款起存金额为不低于50万元人民币的等值外币。
个人外汇储蓄起存限额是多少	个人外汇储蓄起存限额为：1.个人活期储蓄起存额不低于20元人民币的等值外币。2.定期储蓄存款起存额不低于50元人民币的等值外币，同时支持预约转存。3.通知存款起存金额不低于2万元人民币的等值外币。
个人外汇储蓄存款可以受理哪些币种	目前个人外汇储蓄可以办理现汇和现钞储蓄。现汇项下我行可以办理美元、港币、日元、欧元和英镑五个币种的个人外汇储蓄业务。现钞项下可以办理美元、港币、日元和欧元四个币种的个人外汇储蓄业务。
济宁银行SWIFT代码是多少	我行的SWIFT代码为BKJNCNBJXXX。
办理国际业务的收费标准	办理国际业务的具体收费建议您拨打我行客服热线400-677-0537咨询或直接到我行支行咨询。
开立临时存款账户需要什么资料	存款人申请开立临时存款账户,应向银行出具下列证明文件：（1）临时机构，应出具其驻在地主管部门同意设立临时机构的批文。（2）异地建筑施工及安装单位，应出具其营业执照正本或其隶属单位的营业执照正本，以及施工及安装地建设主管部门核发的许可证或建筑施工及安装合同。（3）异地从事临时经营活动的单位，应出具其营业执照正本以及临时经营地工商行政管理部门的批文。（4）注册验资资金,应出具工商行政管理部门核发的企业名称预先核准通知书或有关部门的批文。
支行的地址和电话是什么	LB0101
营业部	营业部：山东省济宁市金宇路6号（济宁银行金宇路办公大楼） 电话：0537-2899026。
市北支行	市北支行：洸河路84-18号（仙营绿地向西路南） 电话：0537-2359376。
洸河支行	洸河支行：金宇路、琵琶山路交叉口向北路东（佳世客东门对面） 电话：0537-2399706。
洸河中路支行	洸河中路支行：洸河路158号（洸河路、古槐路交叉口向东路南，湖嘉对面） 电话：0537-2272866。
西城支行	西城支行：太白西路148-6号（太白路、济安桥路交叉口向西路北，鲁抗医院向东） 电话：0537-2271276。
共青团支行	共青团支行：红星中路20号（市政府对过，原人行大楼） 电话：0537-2310939。
开发区支行	开发区支行：吴泰闸路43号（贵和花园酒店对面） 电话：0537-2330666。
吴泰闸支行	吴泰闸支行：吴泰闸路145号（吴泰闸路、共青团路交叉口向东路北，都市花园附近） 电话：0537-2785768。
任城支行	任城支行：运河路22号（太白路、运河路交叉口向南路东，秀水城向南） 电话：0537-2328922。
运河支行	运河支行：红星西路（红星西路阳光花园小区，锡龙大酒店向东路南） 电话：0537-2213567。
红星支行	红星支行：红星东路37号（红星东路、英华路交叉口向东路南，火炬大厦附近） 电话：0537-2324161。
海关支行	海关支行：琵琶山路、海关路交叉口向南路西（琵琶山北路石油公司综合楼） 电话：0537-2164721。
樱花支行	樱花支行：太白东路67号（太白路、英华路交叉口向东路南，齐鑫花园西邻） 电话：0537-2335888。
太白支行	太白支行：济宁市万达广场6号楼一层0114-0118（万达金街内） 电话：0537-2319256。
市中支行	市中支行（原营业部）：济宁市古槐路58号（济宁附属医院对面古槐路路东） 电话：0537-2215490。
解放路支行	解放路支行：建设南路12号（解放路、建设南路交叉口向东路北，电力二处向南） 电话：0537-2896559。
龙行路支行	龙行路支行：龙行路中段212号（龙行路与环城西路交汇口） 电话：0537-2882855。
曲阜支行	曲阜支行：曲阜弘道路36号（曲阜舞雩台路、弘道路交叉口向北路东） 电话：0537-4891678。
曲阜静轩路支行	曲阜静轩路支行：曲阜静轩西路39号 电话：0537-4676678。
邹城支行	邹城支行：峄山北路、太平东路交叉口向东路南，邹城市文化广场对面 电话：0537-5115788。
邹城宏河支行	邹城宏河支行：邹城市宏河路3696号（邹城宏河路、凫山南路交叉口向西，馨苑小区附近）电话：0537-5309866。
邹城钢山支行	邹城钢山支行：邹城市东滩路1869号鑫源国际城B座 电话：0537-5111607。
微山支行	微山支行：微山县奎文东路52号（微山县中医院附近） 电话：0537-8233766。
微山欢城支行	微山欢城支行：微山县欢城镇工商所南邻（微山县第三人民医院附近） 电话：0537-8615788。
梁山支行	梁山支行：梁山县水泊中路117号（水泊中路、文化路向西南路北，银都小区附近） 电话：0537-7305966。
梁山拳铺支行	梁山拳铺支行：梁山县拳铺镇工业园区220国道东侧  电话：0537-7763966。
嘉祥支行	嘉祥支行：嘉祥县呈祥路9号  电话：0537-6822799。
金乡支行	金乡支行：金乡县奎星路11号（奎星路、北斗路交叉口向西，金乡县卫生局对面） 电话：0537-8753311。
兖州支行	兖州支行：兖州市北护城河路72号（北护城河路、中御桥路北交叉口，姚树人麻辣鱼兖州店） 电话：0537-3480622。
兖州紫金城支行	兖州紫金城支行：兖州市建设西路华勤紫金城华金中心36号 电话：0537-5179877。
汶上支行	汶上支行：汶上县中都大街2888号  电话：0537-7167189。
泗水支行	泗水支行：泗水县泉鑫路7号   电话：0537-4368692。
鱼台支行	鱼台支行：鱼台县湖陵二路401号（新亿客购物广场附近） 电话：0537-6219388。
枣庄分行	枣庄分行：枣庄市市中区青檀路2号（中国银行对面） 电话：0632-3607088。
滕州支行	滕州支行：枣庄市滕州市学院中路（龙山中路、教场巷交叉口向西路南，枣庄市仁和耳鼻喉滕州医院斜对） 电话：0632-5806667。
滕州荆河中路支行	滕州荆河中路支行：滕州市荆河中路108号电话：0632-5800021。
菏泽分行	菏泽分行：菏泽市长江路、和平路交叉口东南角，中达商城附近，平安人寿旁边电话：0530-5869015。
淄博分行	淄博分行：淄博市张店区新村西路42号铂金商务大厦（柳泉路与新村西路交叉口，精彩电影城附近） 电话：0533-5207788。
泰安分行	泰安分行：泰安市泰山大街3168号（光彩大市场附近） 电话：0538-8725877。
支行几点下班	济宁银行营业网点营业时间：春夏季：8:30-16:30秋冬季：8:30-16:00。
火炬路支行	火炬路支行：火炬中路新亚福综合楼。电话：0537-2655117。
郓城支行	郓城支行：郓城县金河路与金利街交汇处（人社局办公大楼西楼） 电话：0530-6308906。
牡丹支行	牡丹支行：菏泽市中华西路时代奥城北门东侧  电话：0530-5869055。
牡丹路小微支行	牡丹路小微支行：菏泽市牡丹路汽车站北邻种子公司楼下 电话：0530-5869051。
曹州路小微支行	曹州路小微支行：菏泽市青州路南华街口东50米路北 电话：0530-5869071。
枣庄解放路支行	枣庄解放路支行：枣庄市市中区解放路279号 电话：0632-3607001。
薛城支行	薛城支行：山东省枣庄市薛城区燕山路601号 电话：0632-7661899。
宁阳支行	宁阳支行：泰安市宁阳县七贤路与文化街交汇处 电话：0538-5688797。
临沂分行	临沂分行：山东省临沂市沂蒙北路81号（临沂市广州路与沂蒙路交汇处） 电话：0539-8962026。
日照分行	日照分行：山东省日照市东港区海曲东路58号海曲国际大厦 电话：0633-3387676。
新天地小微支行	新天地小微支行：曲阜市裕隆路99号新天地商住中心2号楼208-209 电话：0537-4431456。
兴隆街小微支行	兴隆街小微支行：济宁市兖州区兴隆街南首（金都商城对过） 电话：0537-3416898。
城后路小微支行	城后路小微支行：微山县城后路30号 电话：0537-8223688。
嘉祥建设路支行	嘉祥建设路支行：嘉祥县建设路中央华府6号楼 电话：0537-6867799。
呈祥路小微支行	呈祥路小微支行：嘉祥县呈祥路113号 电话：0537-6819399。
金兴商贸城小微支行	金兴商贸城小微支行：金乡县文峰路西段南中心大道西侧 电话：0537-8710266。
奎星湖小微支行	奎星湖小微支行：金乡县奎星湖花园C区望湖绿苑小区1号楼 电话：0537-8720286。
泗水光明路支行	泗水光明路支行：山东泗水县光明路13号 电话：0537-4368699。
湖凌三路小微支行	湖凌三路小微支行：鱼台县湖凌三路金贤源东区门南 电话：0537-6213003。
森泰御城社区支行	森泰御城社区支行：济宁市森泰御城小区红星路一层门面房 电话：0537-3234002。
冠亚星城社区支行	冠亚星城社区支行：济宁市冠亚星城小区内A13号商铺 电话：0537-3234008。
科苑路社区支行	科苑路社区支行：济宁市科苑商业街2号楼一层南端 电话：0537-3234004。
龙城美墅社区支行	龙城美墅社区支行：济宁市太白路龙城美墅3号楼东起第10户1-2层营业房电话：0537-3234006。
豪德商贸城社区支行	豪德商贸城社区支行：济宁市市中区105国道与太白路交汇处南200米沿街营业楼 电话：0537-3234010。
豪丰庄园社区支行	豪丰庄园社区支行：济宁市古槐辖区豪丰庄园北数第四户营业房 电话：0537-3234012。
巨野支行	巨野支行：巨野县人民路与招商街交汇处（路口西南角）电话：0530-8158900。
曹县支行	曹县支行：曹县青菏南路路西建委南鑫龙小区 电话：0530-3820015
滕州善国路支行	滕州善国路支行：滕州市善国南路1515号 电话：0632-5806017
义乌社区支行	义乌社区支行：淄博市张店区华光路151甲15号 电话：0533-3129966
沂源支行	沂源支行：淄博市沂源县鲁山路23号 电话：0533-3368866
泰山支行	泰山支行：泰安市泰山区虎山路与灵山大街交汇处 电话：0538-5010888
南门支行	南门支行：济宁市任城路33号 电话：0537-2264716
水泊支行	水泊支行：梁山县水泊中路90号 电话：0537-7610766
宝相寺支行	宝相寺支行：汶上县宝相寺路68号 电话：0537-7167198
微信银行的功能	我行微信银行可以为您提供账户查询，资金管理，紧急挂失，开户行查询，无卡取现，金融信息查询等一系列功能服务。
微信银行的绑定方式	您可以关注我行微信银行后，选择“账户管理——账号绑定”绑定微信银行。
如何解绑微信银行	您可以选择“账户管理——账号解绑”解绑微信银行。
微信银行的收费标准	目前签约办理我行微信银行不收取任何费用。
微信银行登录密码设置规则	目前我行微信银行登录时不需要校验登录密码。
微信银行支付密码设置规则	目前我行微信银行支付密码就是您的银行卡交易密码。
微信银行能否进行转账汇款	我行微信银行暂时只支持本人账户互转。
微信银行行内转账	我行微信银行暂时只支持本人账户互转，无法转向他人账户。
微信银行跨行转账	我行微信银行暂时只支持本人账户互转，无法进行跨行转账。
微信银行定活互转限额	我行微信银行对定活互转，未做任何限额设定。
网上银行如何查看定期存款	您好，网上银行查看定期存款需要您先登录网上银行，进入用户界面，点击“我的常用应用”-“定期存款”，进行查看。
如何申请个人贷款	您好，我行根据不同的个人贷款需求制定了多种针对性强的贷款产品。我行微贷中心专为个体工商户、小微企业办理个人经营性贷款业务。您可以根据自己的需求申请贷款。对符合条件的贷款客户建议您直接联系我行各网点微贷中心咨询。
我的贷款还款历史可查询多长时间	您好，我的贷款还款历史查询可查询一个月、三个月、半年、一年内的历史记录。
我的普通贷款页面可以显示全部吗	您好，我的贷款普通贷款页面不包括全部的贷款信息，其中已经结清或者尚未发放的贷款不显示。
为什么我的贷款没有还款按钮	您好，我的普通贷款中还款按钮只有到当贷款状态为正常时才显示，如果贷款已逾期或转非应计等非正常状态，则不显示。
我的贷款功能	您好，我的贷款功能实现了客户查看我的贷款，包括客户目前已有的未结清普通贷款和已经申请的循环贷款额度信息。
如何办理贷款	您好，您可以到贷款申请页面去做贷款申请，也可直接到网点咨询办理。
定期理财功能能够做什么	您好，定期理财功能，能够实现账号的定期理财功能，可以通过此功能实现普通定期的转存、通知存款的转存、其它定期产品的转存等等功能，同时可以实现定期理财的查询及理财明细等信息的查询。
定期理财不到结息日可以提前支取么	您好，普通定期产品不到结息日可以提前支取一次，支取金额的利率按活期计息。
定期理财产品有哪些产品类型	您好，定期理财产品包括普通定期、通知存款、大掌柜、小掌柜等产品。您也可以直接到定期产品页面中查看详细信息。
怎么续存定期理财产品	您好，定期存入或者定活互转时，可以选择是否自动续存，也可以在我的定期中选择零整进行续存。
为什么我能看到理财产品信息却不能关注	您好，互联网用户可以查看理财产品信息，但是只有登录后才可以加入到关注列表中。
定期理财产品进行转存操作后，收益是如何计算的	您好，定期理财产品的转存分为本息转存，本金转存，具体以转存金额为准。
定期理财产品续存的定义	对于零整产品，每个月需要存入一定金额，这种称为续存。
定期理财产品可以通过什么渠道购买	您好，定期理财产品 的购买可以登录个人网银直接购买，也可以通过手机号快捷支付购买。
活期自动理财功能能够做什么	您好，活期自动理财功能，能够实现活期自动理财的签约，及相关理财明细等查询功能
使用活期自动理财功能需要什么条件	您好，互联网用户可以查看我行活期理财产品信息，大众版和专业版用户才可使用活期自动理财功能。
购买理财产品需要什么条件	您好，大众版和专业版网银用户均可购买理财产品。您需要到柜面做风险评估和签约，才能购买理财产品。
理财产品都有哪些期限	您好 ，理财产品按期限分类可分为1个月、1-3个月、3-6个月、6-12个月以及12个月以上几个类型。
理财产品的起投金额是多少	您好，我行理财产品的起投金额一般为5万元，以1万的整数倍递增，您可以直接查阅理财产品超市了解详细内容。
理财产品有哪些类型	您好，我行目前发行的理财产品分为非保本浮动收益和保证收益类型。
风险等级评估有什么作用	您好，进行风险评估后会根据您的答案进行评估等级分类，方便您选择与您风险等级匹配的合适产品。
我做了风险评估以后还可以重新测么	您好，在您的风险等级后面有重新评估选项，点击即可进行风险评估。
如何购买理财	您好，理财产品，支持用户名+登录密码购买，支持账号+交易密码购买。请登录个人网银后，在【理财首页】，选择相关的理财产品，进行购买。
风险评估的有效期为多长时间	您好，一般理财风险评估有效期为一年。
理财产品的投资收益率如何计算	您好，客户期末参考收益=投资本金*预期年化收益率*实际存续天数/365。
理财产品未到期可以提前赎回吗	您好，我行目前发行的理财产品均为封闭式产品，不可提前赎回。
何时会发行较高收益的专享理财产品	您好，在相关法定节假日我行会适时推出专享高收益理财，您可随时关注我行的相关宣传信息。
理财产品可以通过什么渠道购买	您好，理财产品的购买可以登录个人网银直接购买，也可以通过手机银行或我行营业网点进行购买。
如何签约快捷支付	您好，登录网上银行，进入到签约模块，选择快捷支付签约中，选择相应的类型进行签约。
开通快捷支付的支付渠道有哪些	您好，网上银行开通快捷支付的支付渠道：如支付宝快捷支付，京东快捷支付，苏宁易购快捷支付等
什么账户可以开通快捷支付	您好，网上银行签约快捷支付的账号为：此客户在网银下挂的所有柜签账号，且卡的状态为正常。
如何修改快捷支付限额	您好，网上银行签约快捷支付录入页面的支付日累计限额，日累计限额为系统根据当前客户的风险等级返回的银行默认限额，签约时仅允许客户调低限额，不允许用户调高限额。修改流程如下：登录网上银行，进入签约模块，点击快捷支付，查看签约情况，点击修改限额进入相应流程。
网上银行签约快捷支付需要验证什么	您好，网上银行的快捷支付新增和签约确认提交时均需要验证客户的认证方式。
签约快捷支付的认证方式有哪些	您好，网上银行签约快捷支付的认证方式为; 一代U-key：U-key+PIN码 ，二代U-key：U-key+PIN码，令牌：令牌挑战码+挑战码。
如何解约快捷支付	您好，登录网上银行，进入签约模块，点击快捷支付，查看签约情况，选择相应的账号进行解约。
解约快捷支付时需要验证什么	您好，网上银行解约快捷支付时只需验证账号密码，不验证认证方式。
解约快捷支付后再签约还需要风险评估吗	您好，网上银行解约快捷支付后，如果再次签约，不需重新做风险评估。
修改快捷支付限额的业务规则	您好，网上银行修改快捷支付限额业务的规则：1.网上银行可以修改快捷支付的日累计限额。2.网上银行可以修改快捷支付限额为临时限额,临时限额可高于默认限额，只是当天有效3.网上银行修改快捷支付限额时，需要验证用户认证方式
修改快捷支付限额的认证方式	您好，网上银行修改快捷支付限额的用户认证方式: 一代U-key：U-key+PIN码；二代U-key：U-key+PIN码；令牌：令牌挑战码+开机密码。
如何修改快捷支付的风险评估	您好，登录网上银行，进入签约模块，点击快捷支付，进入右上角的重新评估功能。
快捷支付修改风险评估的业务规则	您好，网上银行快捷支付风险评估修改的业务规则:1.风险评估完成后，可对限额进行修改。2.当用户做完风评后，不管用户是否签约，风险评估结果都有效。
如何查询快捷支付交易记录	您好，登录网上银行，进入签约模块，点击快捷支付，进入右上角的交易记录查询功能。
查询快捷支付交易记录的业务规则	您好，网上银行查询快捷支付交易记录的业务规则：1.查询时间不超过三个月。2.查询内容区分：支付渠道和支付账号。3.默认查询结果为最近一个月交易记录。
网上银行可以签约自助设备的哪些功能	您好，网上银行可以在网银端做自助设备转账签约，解约，限额修改的功能
网上银行如何签约自助设备的转账功能	您好，登录网上银行，进入签约模块，进入银联转账签约模块，可以进行自助设备转账签约。
网上银行如何解约自助设备的转账功能	您好，登录网上银行，进入签约模块，进入银联转账签约模块，查看签约情况，可以进行自助设备转账解约。
网上银行如何修改自助设备的转账限额	您好，登录网上银行，进入签约模块，进入银联转账签约模块，查看签约情况，可以修改自助设备的转账限额。
网上银行签约自助设备转账的业务规则	您好，网上银行签约自助设备转账的业务规则:柜面签约的银行卡，可以进行自助设备的转账签约。
网上银行解约自助设备转账的业务规则	您好，网上银行解约自助设备转账的业务规则:1.只有签约后的账号才有解约功能。2.解约操作只需要验证用户身份信息。3.用户信息验证需要验证签约账号交易密码和认证方式。
网上银行修改自助设备转账限额的业务规则	您好，网上银行修改自助设备转账限额的业务规则：1.只有签约后的账号才有修改限额功能。2.修改限额时，额度默认显示之前签约时设置的限额额度。3.用户信息验证需要验证签约账号交易密码和认证方式。
什么是交易密码	您好，济宁银行网上银行交易密码即您的银行卡取款密码。
网上银行登录密码忘记了怎么办	网上银行提供“找回密码”功能，如您遗忘网银登录密码，可以在我行个人网上银行登录界面点击“找回密码”链接（位置在用户名输入框后方），按照页面提示输入相应信息后，便可重新设定网银登录密码。同时，您也可持有效身份证件到我行营业网点办理登录密码重置业务。
网上银行登录密码如何修改	您好，修改登录密码需要您先登录网上银行，进入到设置模块，进入到安全中心，选择登录密码修改的功能。
登录密码锁定怎么办	如果您的网银登录密码锁定：1.网上银行登录密码当日输入5次错误后会临时锁定，次日自动解锁后您还可以输入4次（总计连续9次）；2.如连续9次输入错误会永久锁定，需要本人携带有效身份证件、银行卡至柜面办理；企业网上银行用户需要携带组织机构代码证、营业执照、法人代表身份证件、经办人身份证件、授权书、被锁定操作员或录入员账户的有效身份证件、企业相关印鉴等资料至对公户网银开户网点解锁。
网上银行可以办理手机银行哪些业务	您好，网上银行签约手机银行可以让用户在移动话机上使用网上银行的查询，转账，缴费等功能，提高系统使用的便捷性。
升级大众版手机银行的业务规则	您好，网上银行升级大众版手机银行的业务规则：1.大众版手机银行的用户才可以做升级专业版操作。2.升级的内容包括校验手机号码（大众版手机银行注册的手机号），认证方式。3.认证方式为：一代U-key：U-key+PIN码；二代U-key：U-key+PIN码；令牌：令牌挑战码+开机密码。4.升级操作同：签约专业版手机银行。
网上银行可以办理微信银行哪些功能	您好，网上银行办理微信银行功能有：1.查询已绑定微信账号的银行卡号。2.办理微信银行解约操作。
用户暂停网银的业务规则	您好，网上银行用户暂停网银的业务规则：1.设置临时暂停需要设置临时暂停网银时间，并验证网银预留手机号短信验证码。2.成功设置临时暂停后，在暂停网银时间内登录时，需要验证短信验证码。登录成功后，临时暂停设置失效。3.页面下方增加提示，客户暂停网银后，设置的预约转账和资金归集等业务不受影响会继续执行。 4.暂停网银只是提高网银的登录入口的安全级别。
网上银行如何修改U-Key限额	您好，登录网上银行，从安全中心，选择U-key进行限额修改，进入U-key限额修改页。
网上银行如何修改短信限额	您好，登录网上银行，从安全中心，选择短信进行限额修改，进入限额修改页
网上银行如何停用U-Key	您好，登录网上银行，从安全中心，选择U-key进行关闭，进入U-key关闭页。
网上银行如何启用U-Key	您好，登录网上银行，从安全中心，选择U-key进行开启，进入U-key开启页。
网上银行的认证方式	您好，网上银行的认证方式：U-Key，令牌，短信三种。
网上银行认证方式修改限额的限制	您好，在网上银行某认证方式下限额设定时，默认显示银行设置的，修改时，显示客户之前设置的认证方式限额，但不能超过银行设置的该认证方式限额。
网上银行如何查询操作日志	您好，登录网上银行，进入设置模块，点击“操作日志查询”按钮，进行查看。
网上银行操作日志能下载吗	您好，网上银行操作日志支持excel下载功能。
网上银行能查看的操作日志有哪些	您好，网上银行操作日志可查询客户的登录退出和操作类日志。查询类日志在后台数据库中记录，但是不给客户展示出来。后台记录供后续数据分析做参考。
网上银行查看操作日志的业务规则	您好，网上银行查看操作日志的业务规则：1.操作日志可以根据操作名称及时间范围查看，默认前十条操作日志。2.操作日志默认按时间倒序排列。3.一次查询时间区间不得超过3个月。
网上银行可以查询多久的操作日志	您好，网上银行个人操作日志可查询12个月以内的操作记录。
网上银行默认的常用功能	您好，网上银行用户未进行配置时，显示默认常用功能：账户查询，普通转账，手机充值，资金归集功能。
网上银行常用功能的用途	您好，网上银行用户可以将各个功能添加到“我的常用功能”模块中，并在我的常用功能模块中可以进行对应维护。
网上银行如何查看账户明细查询	登录网上银行，进入用户界面，点击“我的常用应用”-“账户明细查询”，进行查看。
网上银行常用功能可进行哪些操作	您好，网上银行常用功能可进行的操作包括：添加，删除等。
网上银行如何在常用功能列表添加新应用	您好，网上银行常用功能添加应用流程：1.点击添加：进入所有功能点页面，每个功能点对应一个添加的功能。点击添加，该功能点进入到常用应用列表的末端。点击管理，进入管理页面（弹出框），可以对已经添加的功能点进行排序及删除。2.每个功能点的具体页面，都有一个添加的按钮。点击添加，该功能点进入到常用应用列表的末端。
网上银行安全提示所有用户都可以查看么	您好，互联网用户、自主注册用户、柜面签约用户，都可查阅安全提示。
网上银行如何查看安全提示	您好，查看网上银行安全提示，通过顶部导航栏的帮助，点击安全提示进行查看。
网上银行常见问题所有用户都可以进行查看么	您好，互联网用户、自主注册用户、柜面签约用户，都可查阅常见问题。
网上银行如何进入常用下载	您好，通过网上银行顶部导航栏的帮助，进入帮助选择常用下载。
网上银行常用下载都可以下载什么	您好，您在使用网银的过程中，可以进入到常用下载，下载所有网银使用过程中需要的网银助手、密码控件、签名控件（电子签章客户端控件）、U-key驱动、网银证书等等所有下载。
登录网上银行相关控件会自动安装么	您好，登录网上银行时，密码控件、网银助手等一般都会自动加载安装。如果安装过程中遇到问题，您可以到下载中心手动安装。
登录网上银行相关控件没有自动安装怎么办	您好，您在登录网上银行，密码控件、网银助手等一般都会自动加载安装。如果密码控件等没有正常安装，可以点击链接下载至电脑中进行安装。
如何下载个人网银证书	您好，通过网上银行顶部导航栏的客服中心，进入客服中心选择常用下载，进行个人网银证书的下载。
怎样添加扣款账户	您好，添加扣款账户请您先登录网上银行，1.点击左侧导航栏“资金归集”按钮，默认展开实时归集的标签。2.点击导航栏展开的“实时收款”按钮进入实时收款页面。3.点击右上角“添加扣款账户”按钮，弹出添加扣款账号页面。4.根据提示填入信息，完成添加。
怎么添加亲情账户	您好，添加亲情账户请您先登录网上银行，1.点击左侧导航栏“资金归集”按钮，默认展开实时归集的标签。2.点击导航栏展开的“实时收款”按钮进入实时收款页面。3.点击右下角“添加亲情账户”按钮，进入亲情账号添加流程。4.根据流程填入信息，完成添加。
怎么查看具有支付权限的他行账号和已经添加的亲情账号	您好，查看具有支付权限的他行账号和已经添加的亲情账号请您先登录网上银行，进到我的账号列表，会展示您已经添加的具有支付权限的他行账号和已经添加的亲情账号。
他行账户里的收款账户可以更改吗	您好，他行账户里的收款账号自动默认无法修改。
亲情账户里的收款账户可以更改吗	您好，亲情账户里的收款账号可以选择您下挂到网银的您本人所有账号。
网上银行资产概览下都有哪些功能	您好，资产概览包括总资产和总负债。总资产划分为活期，定期，理财，基金，并分别展示不同资产类型的金额。总负债包括未结清贷款余额。
网上银行我的账户下都有哪些功能	您好，我的账户：包括本行存款账户，他行存款，亲情账户。从我的账户下，点击账户详情，跳转到账户详情页。
网上银行常用菜单下都有哪些功能	您好，我们会根据用户使用频率的数据分析，列出用户最常用的菜单功能，例如：行内/跨行转账，账户详情，理财产品购买。同时您也可以自定义自己的常用菜单，设置成功后，会显示在我的常用菜单中。
网上银行个人登录基本信息都包含哪些	您好，个人基本信息包含用户头像，用户名称，上次登录地点和时间，预留信息，用户安全级别和提升链接等。
网上银行重要通知都有哪些	您好，网上银行重要通知包括：1.证书到期前提醒2.证书已过期提醒3.行内资金归集他人申请待确认通知4.密码长时间未修改提醒5.理财产品到期提醒6.缴费账单提醒（系统自动根据用户上次缴费的时间点，记录用户账单日，并在账单日之前几天提醒用户进行缴费）
网上银行总资产是什么	您好，网上银行总资产包括当前客户的所有存款账户的余额之和，如果是外币，会根据实时汇率转化为人民。如果是基金，则根据购买份额和当前净值计算出参考市值累加到总资产当中。
网上银行总负债是什么	您好，网上银行总负债：未结清贷款的剩余金额。
网上银行总资产是如何划分的	您好，总资产划分为活期，定期，理财，并分别展示不同资产类型的金额。
网上银行如何查看消息通知	您好，查看消息通知，请您登录进入网上银行在我的主页点击消息通知，进入消息通知列表页。
网上银行账号管理的作用	您好，账户管理功能提供了用户查看用户已经添加的本行，他行和亲情账户信息，同时支持对以上账户进行新增，删除和挂失等的功能。
如何进行账户添加和删除	您好，在我的账户中删除或添加账号，请您登录进入网上银行个人主页，选择进入账号管理，我的账户，在我的本行账户模块中，选中一个账号点击删除，系统提示用户是否删除账号，点击删除，系统将此账号从网银列表中删除；在我的本行账户模块中，在此页面点击账户添加，进入本行账户添加页，进行账户添加。
网上银行如何在我的账户中进行亲情账户解约	您好，在我的账户中解约亲情账户，请您登录进入网上银行个人主页，选择进入账号管理，我的账户，在我的本行账户模块中，如您的账号已经委托给他人做亲情账号，点击解约，系统会跳转到亲情账号解约页面，进行解约。
网上银行如何在我的账户中查看他行授权管理	您好，在我的账户中查看他行授权管理，请您登录进入网上银行个人主页，选择进入账号管理，我的账户，在我的本行账户模块中，点击他行授权管理，系统会跳转到他行授权管理页，默认选中此账号。
网上银行如何在我的账户中查看亲情账号授权管理	您好，在我的账户中查看亲情账号授权管理，请您登录进入网上银行个人主页，选择进入账号管理，我的账户，我的本行账号下，点击亲情账号授权管理，进入亲情账户授权管理页。
如何接受他人亲情账号申请	您好，接受他人亲情账号申请，请您登录进入网上银行个人主页，选择进入账号管理，在我的本行账号下，点击亲情账号授权管理，进入亲情账户授权管理页，在亲情授权管理页，点击同意，进入亲情账号申请接受页。
如何拒绝他人亲情账号申请	您好，拒绝他人亲情账号申请，请您登录进入网上银行个人主页，选择进入账号管理，在我的本行账号下，点击亲情账号授权管理，进入亲情账户授权管理页，在亲情授权管理页，点击拒绝，亲情账号拒绝成功。
如何进行亲情账号添加	您好，进行亲情账号添加，请您登录进入网上银行个人主页，选择进入账号管理，在我的亲情账户模块，点击添加亲情账户，则系统会跳转到亲情账户添加页，进行账号添加。
亲情账号可以修改别名么	您好，网上银行亲情账号可以进行设置别名，修改别名。请您登录进入网上银行个人主页，选择进入账号管理，在我的亲情账户模块，进行设置或修改。
他行账户如何添加查询账号	您好，添加他行账户查询账户，请您登录进入网上银行个人主页，选择进入账号管理，在我的他行账户下，点击添加查询账号，系统弹出添加查询账号的页面，选择查询账号，被查询行点击提交签约，系统发送到他行进行签约。
他行账户中如何添加扣款账号	您好，添加他行账户扣款账号，请您登录进入网上银行个人主页，选择进入账号管理，在我的他行账户下，点击添加扣款账号，系统弹出添加扣款账号的页面，选择收款账号，扣款行点击提交签约，系统发送到他行进行签约。
他行账户查询账号如何解除	您好，解除他行查询账号，请您登录进入网上银行个人主页，选择进入账号管理，在我的他行账户下，点击协议查询，跳转到协议详情页，在协议详情页，点击解约查询,弹出解约查询确认页,点击确认解约，解约成功或等待其他银行授权的页面。
他行账户扣款账号如何解除	您好，解除他行扣款账号，请您登录进入网上银行个人主页，选择进入账号管理，在我的他行账户下，点击协议查询，跳转到协议详情页，在协议详情页，点击解约扣款,弹出解约扣款确认页,点击确认解约，解约成功或等待其他银行授权的页面。
我的账户的挂失是什么类型的挂失	您好，网银中的账户挂失为口头挂失，请用户尽快到柜面办理正式挂失。
授权亲情账号，他人可以进行哪些操作	您好，亲情账号一旦授权给其他人，其他人可以操作亲情账号进行转账，缴费，存定期，买理财等所有付款操作。
网上银行账户明细查询一次最长的查询周期是多久	您好，网上银行账户明细查询日期默认近一个周，查询结果按最近交易时间倒序排列，一次只能查询三个月.
网上银行如何在我的存款账户中进行转账	您好，在我的存款账户中进行转账，请您登录进入网上银行个人主页，进入账户详情，在我的存款账户下，点击转账，系统会跳转到行内/跨行转账录入页，默认选中此付款账号。
网上银行如何在我的存款账户中存定期	您好，在我的存款账户中存定期，请您登录进入网上银行个人主页，进入账户详情，在我的存款账户下，点击存定期，系统会跳转到整存整取定期存款开立录入页。
网上银行如何在我的存款账户中预约支取	您好，在我的存款账户中预约支取，请您登录进入网上银行个人主页，进入账户详情，在我的存款账户下，点击预约支取，系统会跳转到通知存款预约支取录入页。
网上银行如何在我的存款账户中进行续存	您好，在我的存款账户中进行续存，请您登录进入网上银行个人主页，进入账户详情，在我的存款账户下，点击续存，系统会跳转到零存整取定期存款续存录入页。
网上银行如何在我的存款账户中支取定期	您好，在我的存款账户中支取定期，请您登录进入网上银行个人主页，进入账户详情，在我的存款账户下，点击支取定期，系统会跳转到对应选中的定期存款支取录入页。
网上银行他行账户中如何实时收款	您好，在网上银行他行账户中实时收款，请您登录进入网上银行个人主页，进入账户详情，在我的他行账户下，点击实时收款，系统会跳转到实时收款页。
网上银行他行账户中如何自动收款	您好，在网上银行他行账户中自动收款，请您登录进入网上银行个人主页，进入账户详情，在我的他行账户下，点击自动收款，系统会跳转到自动收款页。
网上银行电子回单统一打印的用途	您好，用户从网上银行办理的转出业务，用户的来账，还有系统自动处理的业务都可以通过网上银行打印回单。
什么是网上银行当日回单打印	您好，当日回单打印指打印客户当时的交易回单。
什么是网上银行历史回单打印	您好，用户可从网上银行发起回单的打印，可以打印用户从网上银行发起的，或者其他渠道发起的，或者他行的来账等业务回单。
网上银行当日回单如何打印	您好，打印网上银行当日回单，请您登录进入网上银行，选择账号管理，在账号管理页面选择电子回单打印，选择当日回单，进行打印。
网上银行历史回单如何打印	您好，打印网上银行历史回单，请您登录进入网上银行，选择账号管理，在账号管理页面选择电子回单打印，选择历史回单，进行打印。
网上银行历史回单打印可以修改时间么	您好，历史打印默认的交易区间是近一个周。可手工修改交易区间。交易区间查询跨度一次不能超过三个月。
网上银行历史回单打印可打印的最长交易区间是多少	您好，历史打印默认的交易区间是近一个周。可手工修改交易区间。交易区间查询跨度一次不能超过三个月。
网上银行如何查询常见问题	您好，查询网上银行常见问题，通过顶部导航首页的帮助，进入帮助点击常见问题，选择您想要查询的问题进行查询。
如何升级大众版手机银行	您好，您可以使用专业版网银，升级大众版的手机银行。
网上银行如何签约手机银行	您好，签约手机银行首先请您先登录网上银行，进到签约模块查看手机银行的签约情况，点击签约可以进入签约流程。
网上银行如何解约手机银行	您好，解约手机银行首先请您先登录网上银行，进到签约模块查看手机银行的签约情况，点击解约进入到解约流程。
签约手机银行时需要验证哪些信息	您好，网上银行签约手机银行时需要验证网银预留手机号的有效性和用户认证方式。
签约手机银行的认证方式	您好，网上银行签约手机银行的认证方式：一代U-key：U-key+PIN码，二代U-key：U-key+PIN码，令牌：令牌挑战码+开机密码。
签约手机银行完成后的注意事项	您好，网上银行签约手机银行成功后，手机银行的下挂账号信息，预留信息，包括登录密码等与网上银行保持一致。
解约手机银行的业务规则	您好，网上银行解约手机银行的业务规则：1.只有签约手机银行的用户才可以做解约操作。2.解约时，不需要验证认证方式。
网上银行注册用户类别都有哪几种	您好，网上银行注册用户类别有：1.非手机银行，非网上银行用户2.手机银行，非网上银行用户3.手机银行，网上银行用户
什么是网上银行免注册登录	您好，网上银行免注册登录指不需要注册我行网上银行，直接使用我行账号和交易密码登录网上银行。
网上银行的登录方式是什么	您好，网上银行登录方式为：1.非手机银行，非网银用户，使用免注册登录方式；使用我行账号和交易密码登录后，设置网银登录密码，进入个人网银主页或登录前页面；2.手机银行，非网银用户，使用网银用户登录方式，直接使用手机号和手机银行登录密码，验证通过后，进入到个人网银主页或登录前页面。3.手机银行，网银用户，使用网银用户登录方式登录，成功后进入到个人网银主页或登录前页面。
网上银行第一次登录后需要完善信息么	您好，网上银行首次登录需要您完善自己的信息。1.：网银用户或手机银行用户，第一次登录需要设置：登录密码和防伪信息。2.非手机银行＋非网上银行用户使用账号和交易密码登录后，需要完善登录密码和防伪信息等。
网上银行登录时什么时候会出现验证码	您好，登录网上银行时，如果您第一次输入用户和密码正确，则不需要验证码；如果您第一次用户或登录密码输入错误，则需要输入图形验证码。
登录使用网上银行的注意事项	您好，您在使用网上银行时请注意：1.请您尽量不要公共场所或网吧使用网上银行。2.离开网上银行时，请您及时点击退出按钮，以防信息被别人误用。
没有开通网银可以登录网上银行么	您好，未开通网银的用户是可以登录网上银行的。1.如果您未开通网上银行但是开通手机银行，可以使用手机号和手机银行密码登录网银;2.如果您网上银行跟手机银行都没有开通，可以通过银行卡账号通过免注册方式登录网银。
大众版网银和专业版网银的功能是一样的么	您好，大众版网银提供查询，缴费，同名转账等功能；专业版网银提供转账汇款、签约等功能；
如何注销个人网上银行	您好，通过网上银行的设置模块，可以暂停网银；如果要永久关闭网银服务，请到柜面办理解约服务。
网上银行登录忘记密码怎么办	您好，如果忘记网上银行登录密码，点击登录框上的“忘记密码”按钮，进入到登录密码重置流程。验证账号、交易密码、身份证号等，认证通过后，设置新密码，重新登录。
如何挂失令牌	您好，登录网上银行，从令牌管理列表页，选择令牌进行令牌挂失，进入令牌挂失流程。
网上银行如何修改令牌限额	您好，登录网上银行，从认证工具管理列表页，选择令牌进行限额修改，进入限额修改页。
网上银行如何停用令牌	您好，登录网上银行，从认证工具管理列表页，选择令牌进行关闭，进入令牌关闭页。
网上银行如何启用令牌	您好，登录网上银行，从认证工具管理列表页，选择令牌进行开启，进入令牌开启页。
网上银行如何同步令牌	您好，登录网上银行，从令牌管理列表页，选择令牌进行令牌同步，进入令牌同步页。
跨行转账的收费标准	您好，目前济宁银行网上银行跨行转账免费。
网上银行如何查看普通转账	您好，网上银行查看普通转账请登录网上银行，进入用户界面，点击“转账”，进行查看。
怎么进入转账汇款首页	您好，进入转账汇款首页从转账首页中点击行内/跨行转账链接，系统跳转到行内/跨行转账首页。
怎么样发起行内或者跨行转账	您好，发起行内/跨行转账需要以下几点：1.在转账首页中点击转账汇款链接跳转到转账汇款首页。2.选择行内/跨行转账，跳转到行内/跨行转账录入页。
怎么在转账汇款首页发起批量转账	您好，在转账汇款首页发起批量转账需要以下几点：1.在转账首页中点击批量转账链接跳转到批量转账首页。2.选择批量转账，点击下方的发起转账按钮进入批量转账转账录入页。
怎么在转账汇款首页进行资金归集	您好，在转账汇款首页进行资金归集需要以下几点：1.您从转账首页中点击资金归集链接跳转到资金归集首页。2.如果您还未签约，选择资金归集，点击立即签约按钮进入资金归集签约页面。
怎样查看转账首页常用收款人	您好，查看转账首页常用收款人请您先从转账首页中点击行内/跨行转账链接跳转到行内/跨行转账首页，登录网上银行，点击“常用收款人”按钮则跳转到常用收款人列表页。
怎样查看转账首页全部收款人	您好，查看转账首页全部收款人请您先从转账首页中点击行内/跨行转账链接跳转到转账汇款首页，首页默认展开常用收款人列表；也可以点击右上方常用联系人查看全部联系人信息。
转账首页里怎么进行单独转账	您好，在转账首页进行单独转账首先请您先从转账首页中点击行内/跨行转账链接跳转到行内/跨行转账首页；同时，您也可以在行内/跨行转账首页中选择收款人后直接转账。
转账首页里如何进行取消免签	您好，进入取消免签请您先从转账首页中点击转账汇款链接跳转到行内/跨行转账首页，在收款人列表中，选择您想要取消免签的收款人取消免签服务。
怎么样跳转到收款人管理页面	您好，跳转到收款人管理页面首先需要您从转账首页中点击行内/跨行转账链接跳转到行内/跨行转账首页，点击首页中的“常用联系人”按钮，跳转到收款人管理页面。
常用转账收款人为什么不展示	您好，常用转账收款人不展示可能是因为您没有登录个人网上银行，您可以登录网上银行查看您的常用联系人信息。
实时收款有什么好处	您好，实时收款的好处在于它实现了在网银上从已经签支付协议的他行账号和已经签约的亲情账号之间发起实时收款的动作。
如何进行实时收款	您好，如果您想进行实时收款首先请您登录网上银行，然后根据以下步骤完成实时收款：1.点击右侧导航栏“资金归集”按钮，默认展开实时归集的标签。2.点击导航栏展开的“实时收款”按钮进入实时收款页面。3.点击“收款”按钮跳转他行转入交易页面。4.根据提示填写收款信息，点击下一步进入确认收款信息页面。5.确认信息填写正确，点击“确定提交”按钮完成收款。
收款交易失败怎么办	您好，如果您的收款交易失败，请您先登录网上银行   按照以下步骤进行：1.点击右侧导航栏“资金归集”按钮，默认展开实时归集的标签。2.点击导航栏展开的“实时收款”按钮进入实时收款页面。3.点击页面中间的“收款”按钮，跳转实时收款录入页面。4.在实时收款录入页面，点击“重选扣款账号”，可展开重选付款账号的列表。5.如果您的账户存在异常，请到我行网点办理相关业务。
扣款周期是怎样划分的	您好，扣款周期划分为每天、每周、每月和其他。选择周时，需选择周一至周日的任意一天；选择月时，需选择指定的一天；选择其他时，频率可手工输入，单位为天；如果选择8，则每8天执行一次。
收款明细查询的作用是什么	您好，收款明细查询的作用是实现了查看实时和自动收款执行的明细的功能。
怎么查询实时收款明细	您好，查询实时收款明细首先请您登录网上银行，按照以下步骤完成查询：1.点击右侧导航栏“资金归集”按钮，默认展开实时归集的标签。2.点击导航栏展开的“收款明细查询”按钮，默认跳转到实时收款明细查询页3.按照查询条件输入收款账号、付款账号和选择扣款日期，点击下方的“查询”按钮，下面显示查询结果。
转账交易查询的功能是什么	您好，转账交易查询提供了查询转账记录的功能，包括单笔转账记录和批量转账记录。
怎么查看单笔转账详情	您好，查看单笔转账详情请您先登录网上银行，按照以下步骤完成查看：1.点击左侧导航栏“转账交易查询”按钮，进入转账交易查询主页面。2.系统默认选中单笔交易查询页面，输入查询条件点击下方“查询”按钮，系统显示单笔交易查询结果。3.选择您想查看的单笔交易查询结果下点击“详情”按钮，跳转到转账交易结果详情页。
怎么查看批量转账详情	您好，查看批量转账详情请您先登录网上银行，然后按照以下步骤完成查看：1.点击左侧导航栏“转账交易查询”按钮，进入转账交易查询主页面。2.点击“批量转账查询”按钮，系统跳转到批量转账交易页面。3.批量交易查询页面下输入查询条件，点击下方的“查询”按钮，系统显示批量交易查询结果。4.选择您想要查看的批量交易查询结果下点击“详情”按钮，跳转到批量转账交易结果详情页。
单笔转账查询方式是什么	您好，单笔转账查询默认查询方式为付款账号和交易区间。您可切换至高级查询，高级查询支持按付款账号，收款方户名，交易金额区间，交易状态和起止查询区间，起止查询区间，提供一个月，三个月，半年的选项，也可手工选择起始时间。
批量转账查询方式是什么	您好，批量转账查询支持您按交易金额区间和起止日期查询区间。起止查询区间，提供一个月，三个月，半年的选项，也可手工选择起始时间。
最多可以查询多久之前的转账交易	您好，在您没有清理网银数据的情况下最长也可查询1年内的转账交易记录。
怎么导出查询结果	您好，如果您需要导出查询结果请您先登录网上银行，按照以下步骤完成导出：1.点击左侧导航栏“转账交易查询”按钮，进入转账交易查询主页面。2.系统默认选中单笔交易查询页面，输入查询条件点击下方“查询”按钮，系统显示单笔交易查询结果。3.点击右侧“导出单笔转账列表”按钮，导出您想要查询的单笔转账列表。
怎么进行汇总打印	您好，汇总打印首先请您先登录网上银行，按照以下步骤完成打印：1.点击左侧导航栏“转账交易查询”按钮，进入转账交易查询主页面。2.点击“批量转账查询”按钮，系统跳转到批量转账交易页面。3.批量交易查询页面下输入查询条件，点击下方的“查询”按钮，系统显示批量交易查询结果。4.点击“汇总打印”按钮，进行汇总打印。
怎么进行明细打印	您好，明细打印首先请您先登录网上银行，按照以下步骤完成打印：1.点击左侧导航栏“转账交易查询”按钮，进入转账交易查询主页面。2.点击“批量转账查询”按钮，系统跳转到批量转账交易页面。3.批量交易查询页面下输入查询条件，点击下方的“查询”按钮，系统显示批量交易查询结果。4.点击“明细打印”按钮，进行明细打印。
汇总打印与明细打印有什么区别	您好，汇总打印与明细打印的区别是汇总打印只打印页面上方的汇总信息。明细打印只打印页面下方的明细信息，如果有分页也全部打印不分页打印。
预约转账管理有什么好处	您好，预约转账管理的好处在于提供了查询之前设置的预约转账指令，对指令详情，指令执行明细进行查询，也可对未执行完毕的的指令进行撤销的操作，还可以直接发起转账。
怎么查询单笔转账预约	您好，查询单笔转账预约请您先登录网上银行，按照以下步骤完成查询：1.点击左侧导航栏“预约转账管理”按钮进入预约转账管理页。2.点击“单笔预约转账查询”按钮进入单笔预约转账查询页面。3.输入预约查询条件，点击下方的“查询”按钮进行查看。
怎么样查看单笔预约详情	您好，查看单笔预约详情请您先登录网上银行。1.点击左侧导航栏“预约转账管理”按钮进入预约转账管理页。2.点击“单笔预约转账查询”按钮进入单笔预约转账查询页面。3.输入预约查询条件，点击下方的“查询”按钮进行查看。4.查询结果中点击您想查看的单笔预约“详情”按钮进入预约转账详情页。
怎么样打印单笔预约详情	您好，打印单笔预约详情请您先登录网上银行，按照以下步骤完成打印：1.点击左侧导航栏“预约转账管理”按钮进入预约转账管理页。2.点击“单笔预约转账查询”按钮进入单笔预约转账查询页面。3.输入预约查询条件，点击下方的“查询”按钮进行查看。4.查询结果中点击您想打印的单笔预约“详情”按钮进入预约转账详情页。5.点击页面下方的“打印列表”按钮进行打印。
如何导出单笔预约详情	您好，导出单笔预约详情请您先登录网上银行，按照以下步骤完成导出：1.点击左侧导航栏“预约转账管理”按钮进入预约转账管理页。2.点击“单笔预约转账查询”按钮进入单笔预约转账查询页面。3.输入预约查询条件，点击下方的“查询”按钮进行查看。4.查询结果中点击您想导出的单笔预约“详情”按钮进入预约转账详情页。5.点击页面下方的“导出列表”按钮进行导出。
怎样对单次预约指令进行撤销	您好，撤销预约指令首先请您先登录网上银行，按照以下步骤完成撤销：1.点击左侧导航栏“预约转账管理”按钮进入预约转账管理页。2.点击“单笔预约转账查询”按钮进入单笔预约转账查询页面。3.输入预约查询条件，点击下方的“查询”按钮进入预约转账详情页。4.查询结果中选择您想要撤退的预约指令点击撤销，弹出撤销确认页，提示是否撤销，点击撤销后，即对此操作完成撤销。
如何查看周期预约详情	您好，查看周期预约详情请您登录网上银行，按照以下步骤完成查看：1.点击左侧导航栏“预约转账管理”按钮进入预约转账管理页。2.点击“单笔预约转账查询”按钮进入单笔预约转账查询页面。3.输入预约查询条件，在预约条件下选择“指定周期”点击下方的“查询”按钮进行查看。4.查询结果中点击您想查看的单笔预约“详情”按钮进入预约转账详情页。
如何对单次预约发起转账	您好，对单次预约发起转账请您先登录网上银行，按照以下步骤完成转账：1.点击左侧导航栏“预约转账管理”按钮进入预约转账管理页。2.点击“单笔预约转账查询”按钮进入单笔预约转账查询页面。3.输入预约查询条件，点击下方的“查询”按钮进入预约转账详情页。4.查询结果中选择您想要发起的单次预约指令点击“转账”按钮，跳转转账确认页面，点击“确认”按钮完成单次预约转账。
如何对周期预约发起转账	您好，对周期预约发起转账需要您登录网上银行，按照以下步骤完成转账：1.点击左侧导航栏“预约转账管理”按钮进入预约转账管理页。2.点击“单笔预约转账查询”按钮进入单笔预约转账查询页面。3.输入预约查询条件，在预约条件下选择“指定周期”点击下方的“查询”按钮进行查看。4.查询结果中选择您想要发起的周期预约指令点击“转账”按钮，跳转转账确认页面，点击“确定”按钮完成周期预约转账。
单次预约转账和周期预约转账有什么区别	您好，单次预约转账和周期预约转账的区别是如果是单次预约，点击转账，将自动撤销该次预约。如果是周期预约，点击转账，将会撤销下一个执行周期的预约，并明确给出下次预约的执行时间。
怎样进行批量预约查询	您好，进行批量预约查询请您先登录网上银行，按照以下步骤完成查询：1.点击左侧导航栏“预约转账管理”按钮进入预约转账管理页。2.点击“批量预约转账查询”按钮进入批量预约转账查询页面。3.输入预约查询条件，点击下方的“查询”按钮进行查看。
怎样查看批量预约详情	您好，查看批量预约详情请您先登录网上银行，按照以下步骤完成查看：1.点击左侧导航栏“预约转账管理”按钮进入预约转账管理页。2.点击“批量预约转账查询”按钮进入批量预约转账查询页面。3.输入预约查询条件，点击下方的“查询”按钮进行查看。4.查询结果中点击您想查看的批量预约“详情”按钮进入预约转账详情页。
如何撤销批量预约	您好，撤销批量预约请您先登录网上银行，按照以下步骤完成撤销：1.点击左侧导航栏“预约转账管理”按钮进入预约转账管理页。2.点击“批量预约转账查询”按钮进入批量预约转账查询页面。3.输入预约查询条件，点击下方的“查询”按钮进行查看。4.选择您想要撤销的批量预约点击后面的“撤销”按钮，弹出撤销确认页，提示是否撤销，确认后完成撤销。
常用收款人有什么功能	您好，常用收款人的功能是实现了查询，新增，删除，修改常用收款人, 以及导出收款人列表的功能，以及从此页面发起单笔和批量转账的功能。
查询收款人的查询条件是什么	您好，查询收款人的查询条件包括收款人账号，手机号，户名，收款行。
如何查询收款人	您好，查看收款人首先请您登录网上银行，点击左侧导航栏的“行内/跨行转账”右上角的“常用收款人”按钮跳转到查询收款人页面，输入您想查询的收款人条件，点击“查询”按钮进行查询。
如何查看全部收款人	您好，查看全部收款人请您先登录网上银行，按照以下步骤完成查看：1.点击左侧导航栏的“行内/跨行转账”点击右上角“常用收款人”按钮跳转到查询收款人页面。2.在查询条件中未输入查询条件默认显示您所有的收款人信息。
如何查看行内/跨行转账常用收款人	您好，查看行内/跨行转账常用收款人请您登录网上银行，点击左侧导航栏“行内/跨行转账常用收款人”按钮跳转到查询收款人页面，页面下面默认打开常用收款人列表。
如何导出行内/跨行转账收款人	您好，导出行内/跨行转账收款人请您先登录网上银行，按照以下步骤完成导出：1.点击左侧导航栏“行内/跨行转账常用收款人”按钮跳转到查询收款人页面。2.点击页面中间的“导出收款人”按钮进行导出收款人数据。
如何修改行内/跨行转账收款人	您好，修改行内/跨行转账收款人请您先登录网上银行，按照以下步骤完成修改：1.点击左侧导航栏的“行内/跨行转账常用收款人”按钮跳转到查询收款人页面。2.在查询条件中未输入查询条件默认显示您所有的收款人信息。3.选择您想要修改的收款人，点击“修改”按钮跳转到收款人修改页面。
如何删除行内/跨行转账收款人	您好，删除行内/跨行转账收款人请您先登录网上银行，按照以下步骤完成删除：1.点击左侧导航栏的“行内/跨行转账常用收款人”按钮跳转到查询收款人页面。2.在查询条件中未输入查询条件默认显示您所有的收款人信息。3.选择您想要删除的收款人，点击“删除”按钮跳转到收款人删除页面。
如何单独向行内/跨行转账收款人转账	您好，单独向行内/跨行转账收款人转账首先请您登录网上银行，然后按照以下步骤完成转账：1.点击左侧导航栏的“行内/跨行转账常用收款人”按钮跳转到查询收款人页面。2.在查询条件中未输入查询条件默认显示您所有的收款人信息。3.选择您想要转账的收款人，点击“转账”按钮跳转到收款人类型对应的转账流程中。
如何查看行内/跨行转账收款人交易记录	您好，查看行内/跨行转账收款人交易记录首先请您登录网上银行，然后按照以下步骤完成转账：1.点击左侧导航栏的“行内/跨行转账常用收款人”按钮跳转到查询收款人页面。2.在查询条件中未输入查询条件默认显示您所有的收款人信息。3.选择您想要查看的收款人交易记录，点击“交易记录”按钮系统跳转到查询转账记录页，同时查询出所选择收款人的转账记录，查询时间区间默认为转账记录查询的默认时间。
如何批量向行内/跨行转账收款人转账	您好，批量向行内/跨行转账收款人转账首先请您登录网上银行，1.点击左侧导航栏的“行内/跨行转账常用收款人”按钮跳转到查询收款人页面。2.在查询条件中未输入查询条件默认显示您所有的收款人信息。3.选择您想要转账的收款人信息，点击“批量转账”按钮，进入批量转账录入页。4.所有选择的收款人信息已经默认选中，输入转账金额。
如何批量删除行内/跨行转账收款人	您好，批量删除行内/跨行转账收款人请您先登录网上银行，然后按照以下步骤完成转账：1.点击左侧导航栏的“行内/跨行转账常用收款人”按钮跳转到查询收款人页面。2.在查询条件中未输入查询条件默认显示您所有的收款人信息。3.选择您想要删除的收款人信息，点击“批量删除”按钮跳出是否删除页面，点击确定按钮完成删除。
如何取消行内/跨行转账免签收款人	您好，取消行内/跨行转账免签收款人请您先登录网上银行，然后按照以下步骤完成取消：1.点击左侧导航栏的“行内/跨行转账常用收款人”按钮跳转到查询收款人页面。2.在查询条件中未输入查询条件默认显示您所有的收款人信息。3.选择您想要取消的行内/跨行转账收款人信息，点击“设置”按钮，选择取消免签。4.系统弹出确认框，点击“确定”按钮解除免签。
导出行内/跨行转账收款人列表是导出什么	您好，导出行内/跨行转账收款人列表是对查询结果的所有收款人进行导出，不是对当前页面查询结果导出。
批量转账有什么作用	您好，批量转账的作用是实现了从本行下挂网银的账户同时向多个账户付款的功能，包括本行和他行账户，他行需支持普通，快速，和实时的转账方式，也支持实时提交转账和预约定时转账的功能。
如何进行模板转账	您好，进行模板转账请您登录网上银行，按照以下步骤完成转账：1.点击“批量转账”按钮，选择“模板转账”按钮进入模板转账录入页。2.选择您要转账收款人信息，点击“转账”按钮进入确认页。（如果转账金额大于5万，弹出的需要选择省市的页面。）3.选择验证方式，点击“确认”按钮完成转账。
如何添加模板转账收款人	您好，添加模板转账收款人请您先登录网上银行，按照以下步骤完成添加：1.点击“批量转账”按钮，选择“模板转账”按钮进入模板转账录入页。2.点击“添加收款人”按钮进入添加收款人页面。3.填写收款人信息，点击“保存”按钮完成添加。
如何删除模板转账收款人	您好，删除模板转账收款人请您先登录网上银行，按照以下步骤完成删除：点击“批量转账”按钮，选择“模板转账”按钮进入模板转账录入页。选择您想要删除的模板收款人信息，点击“删除”按钮进行删除。
如何进行文件导入	您好，文件导入请您先登录网上银行，然后按照以下步骤进行导入：1.点击“批量转账”按钮，选择“文件导入”按钮进入文件导入录入页。2.在文件导入页面正确填写收款人信息，点击“下一步”按钮进入确认转账页面。3.在确认转账页面输入验证方式点击“确认提交”完成文件导入。
快捷录入页面转账用途是什么	您好，快捷录入页面转账用途都默认为网银转账，您也可以手工编辑转账用途。
快捷录入页付款账号可以修改吗	您好，快捷录入页的付款账号可以修改，付款账号默认选中您使用频率最高的账号。
快捷录入页使用亲情号付款限额怎么算	您好，快捷录入页使用亲情号直接付款时，累计的限额累加到当前您登录的限额，限额判断也以当前登录您的限额进行判断。
快捷录入页面增加账号可用余额最低是多少	您好，快捷录入页面增加账号可用余额不能低于转账金额和手续费的判断，如果低于则不允许提交。
快捷录入页手工录入转账一次最多支持多少条转账记录	您好，快捷录入页手工录入转账一次最多支持转20条转账记录。
模块转账中已经保存的模板信息显示有什么	您好，模块转账中已经保存的模板信息显示内容有：模板名称，总金额，总笔数，付款用途。
模板转账录入页已保存的模块信息有什么可以修改	您好，模板转账录入页中已保存的模板信息中的名称和付款用途可以修改。
对已上传交易文件中的总金额总笔数有什么要求	您好，对于已上传交易文件中的总金额、总笔数如果与页面输入不一致或者批量中有重复指令校验不通过的，则整批指令将不能提交。
提交文件内容是什么格式的	您好，提交的文件内容的格式是编号、收款人姓名、账号、付款金额、运单号、公司名称、行内行外标志、联行号、收款银行、收款人手机号，各项之间用逗号隔开，缺少某项值可以不写但逗号不能省略。
行内/跨行转账有什么作用	您好，行内/跨行转账集成了行内转账和行外转账，实现了原行内和行外转账的所有功能。其中：行内转账功能实现了从本行下挂网银的账户转出至本行的借记卡，对公活期账户，对私活期账户，国土资源竞拍保证金账户。
如何进行内/跨行转账	您好，行内/跨行转账首先请您登录网上银行，按照以下步骤完成转账：1.点击“行内/跨行转账”菜单进入跳转到一站式转账录入页面。2.在页面中正确填写转账信，点击“下一步”按钮进入确认转账信息页。3.在确认转账信息页正确输入认证方式，点击“确认提交”按钮，自动跳转是否确认以后给此账户转账不再验证短信验证码页面。4.如果您以后对此账户转账不想验证点击“确认”按钮跳转到转账结果页面完成转账。（如果转账金额大于令牌认证方式的转账日累计限额，则仍需验证U-key认证方式。）如果您以后想进行验证短信验证码，点击“确认”按钮跳转结果页面。
行内/跨行转账失败怎么办	您好，如果行内/跨行转账失败提醒您的账号存在异常，请到我行网点办理相关业务。同时，您也可以直接拨打我行服务电话：4006770537进行咨询。
如何使用常用收款人转账	您好，使用常用收款人转账需要先登录网上银行，然后按照以下步骤进行：1.点击“行内/跨行转账”菜单进入跳转到行内/跨行转账首页，点击页面下方的“常用收款人”可以直接转账；2.同时，您也可通过行内/跨行转账右上角的常用联系人链接，进到常用收款人页面，进行转账；3.您在行内/跨行转账进行转账录入时，可以在收款人旁边点击联系人选择，选择相关联系人进行转账。
如何修改限额	您好，修改限额需要您先登录网上银行，然后按照以下步骤修改：1.点击顶部导航的“设置”菜单进入安全中心页面。2.在页面下面中点击相关认证方式的“修改限额”链接弹出限额修改框。3.正确填写日累计限额和动态验证码，点击“确定”按钮修改成功。
行内/跨行转账常用收款人可以显示有多少条	您好，行内/跨行转账常用收款人下拉列表会根据收款账号的使用频率，从高到底进行排序，显示前10条，超过10条页面下会显示查询更多的链接，点击查询更多的链接，会展示更多常用收款人。
如果收款账号是6个9开头的，转账时需要判断限额吗	您好，如果收款账号是6个9开头的，说明它是缴纳保证金国土资源竞拍等业务，则不走判断限额的流程。
如果转账金额小于5万走什么渠道	您好，如果转账金额小于等于5万，则默认走网银互联渠道和小额。如果您选择的银行开通了网银互联，默认走网银互联。如果您要转的收款行未开通网银互联业务，则查出对应的大小收款银行，默认走小额渠道。如果转账走小额渠道，则需要增加省和市的选择。
如果转账金额大于5万走什么渠道	您好，如果转账金额大于5万，则走大额渠道。收款账号开户行需选择总行和省以及对应的城市。
如果转账金额大于5万又不在大额服务时间内会怎么样	您好，如果转账金额大于5万，不在大额服务时间内时，会提示超过跨行大额快速模式服务时间，系统将转预约处理，系统自动选中预约选项，并将预约信息转为下一工作日。
怎么输入收款银行	您好，输入收款银行可以手工选择，也支持输入行名和行号进行模糊搜索，输入一个汉字和一个数字之后自动触发搜索。
如果转账超过限额怎么办	您好，如果转账超过限额交易金额字段旁边会显示限额修改链接；如果您转账超过限额，可以通过此链接进行限额修改。
设置特殊限额后最高可转金额是多少	您好，如果您设置了特殊限额，则以特殊限额剩余的可用限额为最高可转金额。
付款用途可以修改吗	您好，付款用途默认网银转账，可以修改。
付款账号默认什么账号，可以修改吗	您好，付款账号默认选中您使用频率最高的账号，也可以选择其他账号。
用行内/跨行转账亲情号付款有什么限额	您好，如果您添加了亲情账号，则付款账号中显示亲情账号，使用亲情账号直接付款时，限额会累加到您的转账限额中。
录入页面增加账号可用余额最低是多少	您好，录入页面增加账号可用余额不能小于转账金额和手续费的判断，如果小于则不允许提交。
交易成功后短信通知收款人吗	您好，交易成功后短信通知收款人。如果收款人中保存了手机号，则选择收款人后自动反显。如果是新收款人，并且短信通知收款人，交易成功后，手机号连同收款人信息一并保存到常用收款人中。
什么是网上银行支付	您好，网银支付是电子支付的一种形式，它是通过第三方提供的与银行之间的支付接口进行的即时支付方式。您可以使用网银支付功能进行方便、快捷的网上购物。
网上银行支付的最高限额	您好，网上银行支付限额是默认我行限额，您可以到设置里自行降低限额。
签约网上银行支付的认证方式是什么	您好，网上银行支付签约时，需要验证认证方式。认证方式为：一代U-key：U-key+PIN码 ；二代U-key：U-key+PIN码；令牌：令牌挑战码+开机密码。
如何解约网上银行支付	您好，解约网上银行操作支付如下：1.在网银支付设置中点击解约按钮；2.校验解约卡的取款密码；3.取款密码校验成功从而点击提交，解约成功；4.取款密码校验失败提示相关错误信息；
解约网上银行支付的业务规则是什么	您好，解约网上银行支付的业务规则:1.已签约的账号才可以做解约网银支付功能；2.签约的银行卡是正常状态。
如何查询网上银行支付明细	您好，查询网上银行支付明细可以通过签约模块中的网银支付模块，点击右上角的明细查询即可查询到网上银行支付明细。
如何修改网上银行支付限额	您好，如果想要修改网上银行支付限额可以登录网上银行，进入顶部导航设置模块中，修改网上银行支付限额。
修改网上银行支付限额的业务规则	您好，网上银行支付限额修改的业务规则:有以下几点：1.银行卡是正常状态，不能是冻结、挂失等不正常状态；2.单笔限额金额应小于等于日累计限额金额；3.二次校验单笔限额金额和日累计限额；4.单笔限额和日累计限额文本框要显示上次修改的金额；5.修改需要验证用户认证方式。认证方式为;：一代U-key：U-key+PIN码 ；二代U-key：U-key+PIN码；令牌：令牌挑战码+开机密码。
网上银行如何监测安全	您好，网上银行监测安全需要登录网上银行，进入到设置模块，可以检测您的网银安全情况。
安全监测的功能	您好，网上银行安全监测功能可通过安全监测的方式，提示用户目前的网银安全等级，使用户有针对性的提高网银安全性。
安全监测的业务规则	您好，网上银行安全监测的业务规则：1.可以通过该入口进入修改对应功能的模块。2.登录密码三个月未修改功能，用户可以自行选择忽略设置。忽略后，可恢复提醒，且星级提升。
网上银行安全监测的范围	您好，网上银行安全监测范围包括：预留信息设置，证书更新，登录密码3个月未修改，预留手机设置，网银系统短信通知设置。总评级为五颗星
网上银行如何设置预留信息	您好，在网上银行设置预留信息需要登录网上银行，进入设置模块中的安全中心，可以修改预留信息，在首次登录（注册）时，可以根据提示设置预留信息。
网上银行预留信息的业务规则	您好，网上银行预留信息的业务规则：1.预留信息是在登录网银后，页面会显示的个人独有信息。 2.预留信息可以是数字、字母或汉字，长度在30个字符以内。
网上银行如何更新证书	我行网银证书的有效期为两年。在到期前一个月或到期后六个月内，请您将UKey与电脑连接，然后登录您的个人网上银行，点击“证书管理”-“更新证书”依次进行证书更新、证书下载。若您的Ukey证书到期六个月后需要本人携带有效身份证、银行卡、UK至柜面处理。
网上银行更新证书的业务规则	您好，网上银行更新证书的业务规则：1.证书更新在证书即将到期前一个月内可做，系统会在用户登录后给予提示。2.证书更新后自动联动下载。3.必须是网银登录用户本人的UKEY才能下载成功。4.根据不同厂商UKEY的性质，更新后UKEY中的证书可以有两个，也可以只有一个（替换掉旧的）。5.更新证书有效期时间以更新当日开始为准。
网上银行安全等级有什么作用	您好，网上银行的安全等级可以展示客户账户目前的安全等级，如果安全等级不满格，则显示提升的链接，点击提升链接，可以进入安全等级提升的页面。
网上银行如何个性化设置	您好，网银的个性化设置首先登录网银进入设置模块，进入个人设置的页面，可以设置个人头像，设置常用功能和常用工具。
网上银行个人资料有哪些信息	您好，网上银行个人资料包括基本信息和附加信息。基本信息包括：姓名，用户名，证件类型，证件号码，手机号，通讯地址等；附加信息包括：电子邮箱，单位名称，单位地址等。
网上银行修改个人信息时需要验证吗	您好，网上银行用户资料基本信息中，手机号的修改需要验证签约的认证方式。
网上银行修改登录密码的业务规则	您好，网上银行修改登录密码的业务规则：1.修改密码需要验证原登录密码。2.新密码应由6-20位的数字和字母组成。3.用户3个月未修改登录密码时，当用户登录网银时引导用户修改密码。4.成功修改登录密码后，用户可以继续其他操作。
网上银行如何修改预留手机号	您好，修改网银预留手机号首先登录网上银行，进入设置模块，再进入到个人资料，点击手机号码后的修改按钮。修改手机号需要验证手机号码有效性（验证码）以及用户认证方式。
网上银行修改手机号的业务规则	您好，网上银行修改手机号的业务规则为：1.修改手机号是发送的验证码三分钟内有效，如多次发送，以最后一次为准。2.手机号码校验正确时，获取验证码按钮可以点击。获取验证码过程中，手机号码不可编辑，且按钮不可点击。3.修改页面提示用户：修改手机号码会影响网银预留手机号，核心预留手机号码，网银系统短信通知手机号以及短信验证手机号。
网上银行系统设置指南的作用是什么	您好，网上银行系统设置指南的作用是让用户可以通过查阅网上银行系统设置指南，来帮助自己设置ie参数，和查阅安装密码控件的方法。
哪些用户可以使用网上银行系统设置指南	您好，互联网用户、自主注册用户、柜面签约用户，都可查阅系统设置指南。
网上银行系统设置指南如何进行查阅	您好，查阅网上银行系统设置指南，可以通过顶部导航进入客服中心，在客服中心页面选择系统设置指南进行查阅。
网上银行如何查看资金归集	您好，查看资金归集首先请您登录网上银行，进入用户界面，点击“我的常用应用”-“资金归集”，进行查看。
资金归集有什么优势	您好，资金归集有轻松管理多家银行账户、一次开通、循环归集、省时省力的优势。
资金归集有哪几种方式	您好，资金归集可分为保底归集，全额归集和定额归集三种方式。
保底归集适合什么人	您好，保底归集适合“妻管严”，每月发工资，留下零花钱，其余全部上缴型的人。
全额归集适合什么人	您好，全额归集适合“理财达人”，买理财钱不够了 开通全额归集，有多少归多少，再也不用担心钱不够了。
定额归集适合什么人	您好，定额归集适合“房奴一族”，签约定期归集，设置贷款还款金额为归集金额，每月还贷款的钱自动转到还款账号，省时省力。
如何开通资金归集	您好，开通资金归集首先登录网上银行，按照以下步骤开通：1.点击左侧导航栏“资金归集”按钮，默认展开实时归集的标签；2.点击右上方“立即签约”按钮完成开通。
自动收款有什么作用	您好，自动收款实现了从网银查看已经签约查询和支付协议的他行账号， 和已经签约的亲情账号，并发起自动收款的动作。
如何添加自动收款账号	您好，添加自动收款请您先登录网上银行，然后按照以下步骤添加：1.点击右侧导航栏“资金归集”按钮，默认展开实时归集的标签。2.点击导航栏展开的“自动收款”按钮，进入自动收款首页。3.点击上方的“添加自动收款”按钮，系统跳转到扣款账号选择页。4.点击扣款账号选择页上方“添加他行账号”按钮跳转到添加自动收款录入页。5.按照步骤填写扣款账号、收款账号以及扣款周期等，点击“确认提交”按钮，添加自动收款成功。
怎么删除自动收款账号	您好，删除自动收款请您先登录网上银行，然后按照以下步骤删除：点击右侧导航栏“资金归集”按钮，默认展开实时归集的标签。点击“自动收款”按钮，进入自动收款首页，选择想要删除的扣款账号，点击后面的“删除”按钮，跳出是否删除页面，点击“确认”按钮进行删除。
怎么暂停自动收款	您好，暂停自动收款请您先登录网上银行，点击右侧导航栏“资金归集”按钮，默认展开实时归集的标签。点击“自动收款”按钮，进入自动收款首页，选择想要暂停的扣款账号，点击后面的“暂停”按钮，跳出是否暂停页面，点击“确认”按钮进行暂停。
怎么启用自动收款	您好，启用自动收款请您先登录网上银行，点击右侧导航栏“资金归集”按钮，默认展开实时归集的标签。点击“自动收款”按钮，进入自动收款首页，选择想要启用的扣款账号，点击后面的“启用”按钮，跳出是否启用页面，点击“确认”按钮进行启用。
怎么查询自动收款明细	您好，查询自动收款明细请您先登录网上银行，根据下列步骤查询：1.点击右侧导航栏“资金归集”按钮，默认展开实时归集的标签。2.点击导航栏展开的“收款明细查询”按钮，跳转收款明细页面。3.点击页面上方的“自动收款查询”按钮，跳转实时收款页面。4.按照查询条件输入收款账号、付款账号和选择起止日期，点击下方的“查询”按钮，下面显示查询结果。5.对应您想查询的项目点击后面的“详情”按钮进行查看。
利率查询提供的利率是实时的么	利率查询显示的利率为我行当前执行利率，您也可以手动输入利率进行计算，利率具体以我行公示利率为准。
理财计算器提供的计算结果精确么	您好，理财计算器结果仅供参考。
提前还款计算器提供的计算结果精确么	您好，提前还款计算器结果仅供参考。
外币兑换计算器提供的计算结果精确么	您好，外币计算器结果仅供客户参考，具体以实际兑换业务为准。
贷款查询计算器提供的计算结果精确么	您好，贷款查询计算器提供的计算结果仅供参考。
金融小工具具体有哪些	金融小工具包含汇率查询、贷款提前还款计算器、外币兑换计算器、利率查询、理财计算器等工具。
汇率查询能够提供什么服务	您好，汇率查询能够为您提供实时查询货币汇率服务。
贷款查询计算器能够提供什么服务	您好，贷款查询计算器能够为您提供按揭贷款试算服务
提前还款计算器能够提供什么服务	您好，提前还款计算器能够为您提供提前还款试算服务。
外币兑换计算器能够提供什么服务	您好，外币兑换计算器能够为您提供转换各种货币金额计算的服务。
使用外币兑换计算器有什么需要注意的地方么	您好，使用外币兑换计算器时需注意：持有货币和兑换货币其中有一个必须是人民币，但不能同时都是人民币。
利率查询能够提供什么服务	您好，利率查询功能能够根据我行存款类型和时间不同，显示我行当前的执行利率，方便您了解。
理财计算器能够提供什么服务	您好，理财计算器能够为您提供理财计算功能，根据理财金额、利率、期限试算出预期收益。
如何使用理财计算器	您好，理财计算器的使用需要您在理财计算器页面，输入理财金额、利率、期限，点击试算按钮从而计算出预期收益。
自助缴费有手续费么	您好，目前我行为客户提供免费的自助缴费服务。
济宁银行有哪些网上缴费项目	您好，目前济宁银行的缴费项目有:全国移动话费，固话费以及山东省内联通宽带费您可以到自助缴费页面查看详细信息。
如何添加新的缴费账号	您好，如果您想添加新的缴费账号可以通过生活模块下的添加缴费账号的功能直接添加。
修改缴费号码时可以修改哪些信息	您好，修改缴费号码时可以修改缴费备注，提醒日期，提醒方式以及提醒手机号，其他信息无法修改。
怎么删除我的常用缴费账户	您好，删除我的常用缴费账户请登录个人网银，点击生活一级导航，进入缴费界面，从常用缴费管理中选择要删除的常用缴费项，点击删除，删除该条常用缴费。
怎么添加我的常用缴费账户	您好，添加我的常用缴费账户请登录个人网银后点击生活一级导航，从常用缴费管理选择添加，跳转到缴费号码添加界面，填写相关信息进行添加我的常用缴费账户。
添加新的缴费账户时没有选择短信提醒，将以什么方式提醒我缴费成功	您好，默认消息提醒为网银消息提醒。
公务卡还款	105000
手机银行的收费标准	目前签约办理我行手机银行暂不收取任何业务费用，并且您在转账汇款时不收取转账手续费。但使用手机银行时通讯运营商会收取您一定金额的短信费用（根据您发起业务申请的多少而定）。
能告诉我你的电话么	济宁银行全国热线电话号码为400-677-0537;村镇银行的电话为400-005-3716。
打电话聊会	济宁银行全国热线电话号码为400-677-0537;村镇银行的电话为400-005-3716。
电话号码发过来	济宁银行全国热线电话号码为400-677-0537;村镇银行的电话为400-005-3716。
电话里聊,告诉我	济宁银行全国热线电话号码为400-677-0537;村镇银行的电话为400-005-3716。
电话聊好吗	济宁银行全国热线电话号码为400-677-0537;村镇银行的电话为400-005-3716。
你真棒	谢谢您的夸奖，“如意”随时为您解答业务问题。
傻子	不要这样说嘛，我也正在努力，相信以后一定会让您满意的。
下雪了	您想和人家一起堆雪人吗？
我美吗？	你本来就很美。
