IC卡闪付是什么	什么是IC卡闪付？
今天刷卡消费，没有打印签购单，银行卡已扣账，我该如何处理？	今天刷卡消费，没有打印签购单，银行卡已扣账，我该如何处理？
我今天买东西刷卡付款，签字的单子没有出来，怎么办？	今天刷卡消费，没有打印签购单，银行卡已扣账，我该如何处理？
刚刚刷卡，没出单子，怎么办？	今天刷卡消费，没有打印签购单，银行卡已扣账，我该如何处理？
刚刚刷卡，没出单子，收到扣款短信了，怎么办？	今天刷卡消费，没有打印签购单，银行卡已扣账，我该如何处理？
今天刷卡没有打单怎么办？	今天刷卡消费，没有打印签购单，银行卡已扣账，我该如何处理？
刚刚我刷卡消费，为什么没有出单子，银行卡就扣账了？	今天刷卡消费，没有打印签购单，银行卡已扣账，我该如何处理？
今天刷卡不成功，怎么办？	今天刷卡消费，没有打印签购单，银行卡已扣账，我该如何处理？
刚才POS交易没打单，如何处理？	今天刷卡消费，没有打印签购单，银行卡已扣账，我该如何处理？
今天的交易，刷卡不成功，怎么办？	今天刷卡消费，没有打印签购单，银行卡已扣账，我该如何处理？
刚刚消费交易没有打单，但钱扣了，如何处理？	今天刷卡消费，没有打印签购单，银行卡已扣账，我该如何处理？
POS交易能查询商户名称吗？	POS交易能查询商户名称吗？
我卡里一笔消费，如何查询商户名称？	POS交易能查询商户名称吗？
我刷卡时回单上的商户名和买东西时看到商户名不一样	POS交易能查询商户名称吗？
刷卡消费与信用卡账单地址不一样怎么回事	POS交易能查询商户名称吗？
是不是用银行卡号就查得到在那消费和MTV交易	POS交易能查询商户名称吗？
卡里有一笔不明消费，请帮助查询一下商户名称。	POS交易能查询商户名称吗？
我是持卡人，帮我查下交易明细	POS交易能查询商户名称吗？
银行给我提供了这笔交易的商户编号，能查询到商户地址吗？	银行给我提供了这笔交易的商户编号，能查询到商户地址吗？
POS交易查询	银行给我提供了这笔交易的商户编号，能查询到商户地址吗？
商户编号能查什么？	银行给我提供了这笔交易的商户编号，能查询到商户地址吗？
我想通过POS编号查，是哪个酒店行吗？	银行给我提供了这笔交易的商户编号，能查询到商户地址吗？
我想查一个商户编号	银行给我提供了这笔交易的商户编号，能查询到商户地址吗？
麻烦查下，<数字>(商户编号)，对应商户名	银行给我提供了这笔交易的商户编号，能查询到商户地址吗？
<数字>交易地点是哪里	银行给我提供了这笔交易的商户编号，能查询到商户地址吗？
麻烦查下，<数字>，对应商户名	银行给我提供了这笔交易的商户编号，能查询到商户地址吗？
<数字>D扣三百元请查一下商户信息，谢谢	银行给我提供了这笔交易的商户编号，能查询到商户地址吗？
用商户代码能查出刷卡地址吗	银行给我提供了这笔交易的商户编号，能查询到商户地址吗？
我有商户编号，能查在哪消费的吗？	银行给我提供了这笔交易的商户编号，能查询到商户地址吗？
其只有商户编号，可以查询吗	银行给我提供了这笔交易的商户编号，能查询到商户地址吗？
这个商户代码对应的商户地址在哪儿？	银行给我提供了这笔交易的商户编号，能查询到商户地址吗？
这个商户代码地址在哪里	银行给我提供了这笔交易的商户编号，能查询到商户地址吗？
这个商户编号地址在哪里	银行给我提供了这笔交易的商户编号，能查询到商户地址吗？
这个商户代码对应的地址在哪里	银行给我提供了这笔交易的商户编号，能查询到商户地址吗？
我有ATM的终端编号，麻烦帮我查一下对应的地址。	我有ATM的终端编号，麻烦帮我查一下对应的地址。
ATM地址查询	我有ATM的终端编号，麻烦帮我查一下对应的地址。
根据ATM终端编号能够查询哪些信息？	我有ATM的终端编号，麻烦帮我查一下对应的地址。
ATM终端编号能够查询ATM银行名称吗？	我有ATM的终端编号，麻烦帮我查一下对应的地址。
我想查一个终端号，能不能看到具体位置	我有ATM的终端编号，麻烦帮我查一下对应的地址。
提供终端号，能否查到具体位置？	我有ATM的终端编号，麻烦帮我查一下对应的地址。
我想问一下通过自助取款机的代号能查出具体位置吗	我有ATM的终端编号，麻烦帮我查一下对应的地址。
你好，我想知道***在***哪里的ATM机	我有ATM的终端编号，麻烦帮我查一下对应的地址。
ATM终端号能够查询什么？	我有ATM的终端编号，麻烦帮我查一下对应的地址。
ATM的终端编号	我有ATM的终端编号，麻烦帮我查一下对应的地址。
这台机器的编号是<数字>，具体地址是在哪里？	我有ATM的终端编号，麻烦帮我查一下对应的地址。
我不记得我有取过钱，能否查一下机具编码的地址？	我有ATM的终端编号，麻烦帮我查一下对应的地址。
终端编号查地址	我有ATM的终端编号，麻烦帮我查一下对应的地址。
终端号查询银行	我有ATM的终端编号，麻烦帮我查一下对应的地址。
请帮我查询一下这张银行卡是属于哪家银行的？	请帮我查询一下这张银行卡是属于哪家银行的？
好，我是江苏徐州一名警察，办理一起案件时，需要查询几个银行卡，知道卡号，但是不知道是哪个银行发行的，能帮我看看吗	请帮我查询一下这张银行卡是属于哪家银行的？
你好！请问<数字>是那间银行的账号	请帮我查询一下这张银行卡是属于哪家银行的？
这张卡是哪里发的	请帮我查询一下这张银行卡是属于哪家银行的？
根据卡号能够查询什么信息？	请帮我查询一下这张银行卡是属于哪家银行的？
这是哪家银行卡？	请帮我查询一下这张银行卡是属于哪家银行的？
这张银行卡是哪家银行发行的？	请帮我查询一下这张银行卡是属于哪家银行的？
请帮我查一下卡片的开户行	请帮我查询一下这张银行卡是属于哪家银行的？
请帮我查一下卡片的开户银行	请帮我查询一下这张银行卡是属于哪家银行的？
我想知道这是哪家银行的卡。	请帮我查询一下这张银行卡是属于哪家银行的？
我只有一个卡号，我怎么知道它是哪家银行的？	请帮我查询一下这张银行卡是属于哪家银行的？
<数字>的卡片是哪家银行的？	请帮我查询一下这张银行卡是属于哪家银行的？
<数字>属于哪个银行？	请帮我查询一下这张银行卡是属于哪家银行的？
请帮我查询一下这张卡是属于工商银行的吗？	请帮我查询一下这张银行卡是属于哪家银行的？
请帮我查询一下该笔交易的具体时间。	请帮我查询一下该笔交易的具体时间。
怎么查询交易时间？	请帮我查询一下该笔交易的具体时间。
我要查询交易时间	请帮我查询一下该笔交易的具体时间。
交易具体时间你们能够查询得到吗？	请帮我查询一下该笔交易的具体时间。
帮我查询一下交易时间	请帮我查询一下该笔交易的具体时间。
我要查交易具体时间	请帮我查询一下该笔交易的具体时间。
可以查询刷卡交易的时间吗？	请帮我查询一下该笔交易的具体时间。
这个交易是几点几分发生的？	请帮我查询一下该笔交易的具体时间。
这笔交易是什么时候发生的？	请帮我查询一下该笔交易的具体时间。
查询交易日期	请帮我查询一下该笔交易的具体时间。
ATM取款，现金没有拿到，银行卡已扣账，该如何处理？	ATM取款，现金没有拿到，银行卡已扣账，该如何处理？
您好，我在河北省冀州市冀新路ATM机跨行取款，钱没取出来	ATM取款，现金没有拿到，银行卡已扣账，该如何处理？
今天我在自动取款机取了一次钱，怎么扣了我两次费？	ATM取款，现金没有拿到，银行卡已扣账，该如何处理？
取款不成功怎么办	ATM取款，现金没有拿到，银行卡已扣账，该如何处理？
我在农行取<数字>但只出来了<数字>，我是建设银行的但在农行取得	ATM取款，现金没有拿到，银行卡已扣账，该如何处理？
取款机没出钱怎么办	ATM取款，现金没有拿到，银行卡已扣账，该如何处理？
没取到钱，怎么办？	ATM取款，现金没有拿到，银行卡已扣账，该如何处理？
扣账未扣钞，该如何处理？	ATM取款，现金没有拿到，银行卡已扣账，该如何处理？
取款失败，但钱扣了，该如何处理？	ATM取款，现金没有拿到，银行卡已扣账，该如何处理？
ATM取款，钱没取出来，但账户被扣款	ATM取款，现金没有拿到，银行卡已扣账，该如何处理？
取款，扣账未扣钞	ATM取款，现金没有拿到，银行卡已扣账，该如何处理？
取款机上取钱，钱没出来，卡上扣钱了	ATM取款，现金没有拿到，银行卡已扣账，该如何处理？
取款机上取钱不成功，但是卡上已经扣钱了，怎么办	ATM取款，现金没有拿到，银行卡已扣账，该如何处理？
我在农行的取款机上取钱，钞票没有拿到，钱给扣了，怎么办？	ATM取款，现金没有拿到，银行卡已扣账，该如何处理？
上个月在取款机上取现金，没有取到，扣账了，如何处理	ATM取款，现金没有拿到，银行卡已扣账，该如何处理？
上个月在ATM机上取现金，没有取到，扣账了，如何处理	ATM取款，现金没有拿到，银行卡已扣账，该如何处理？
在取款机上取现金，没有取到，扣账了，如何处理	ATM取款，现金没有拿到，银行卡已扣账，该如何处理？
ATM取款，现金没有拿到，银行卡已扣账，该如何处理	ATM取款，现金没有拿到，银行卡已扣账，该如何处理？
<数字>月<数字>号我在ATM上取款，现金没有拿到，银行卡已扣账，该如何处理	ATM取款，现金没有拿到，银行卡已扣账，该如何处理？
POS商户入账时间有多长？	POS商户入账时间有多长？
你好，我想问下某时间刷的卡，现在没到账，什么回事	POS商户入账时间有多长？
我今早刷的卡，现在没到账	POS商户入账时间有多长？
我昨天刷了卡，怎么还没有到账	POS商户入账时间有多长？
我平常是实时到帐的，为什么今日还没到帐	POS商户入账时间有多长？
商户钱没有到帐	POS商户入账时间有多长？
我昨天刷的卡为什么今天到不了账	POS商户入账时间有多长？
刷卡消费几个工作日到账	POS商户入账时间有多长？
POS钱到账	POS商户入账时间有多长？
你好<数字>号客户在我的黑POS刷卡后现在还没有到账，请问是什么情况？	POS商户入账时间有多长？
客户在我的POS刷卡后现在还没有到账，请问是什么情况？	POS商户入账时间有多长？
我想问下怎样投诉？我刷卡有两笔没有到账	POS商户入账时间有多长？
POS机刷卡未到帐	POS商户入账时间有多长？
昨天在在商店刷了<数字>元可是钱没进到人家账户	POS商户入账时间有多长？
<数字>，<数字>月<数字>日，有两笔交易到现在还没到	POS商户入账时间有多长？
我昨天用刷卡机刷卡可是钱还没有到账	POS商户入账时间有多长？
我是商户昨天用POSS机刷卡今天的钱还没有打到卡上是怎么回事	POS商户入账时间有多长？
你好我刷客户的没有到账	POS商户入账时间有多长？
我在别的平台刷卡一直没到账	POS商户入账时间有多长？
有一单<数字>的刷单。没有到帐	POS商户入账时间有多长？
昨天在在商店刷了六十块可是钱没进到人家账户	POS商户入账时间有多长？
我昨天刷的卡为什么钱还没到	POS商户入账时间有多长？
你好！我昨天顾客刷的<数字>怎么没到账	POS商户入账时间有多长？
<数字>月<数字>号的时候我刷了一笔<数字>的单子，没有收到款怎么回事啊	POS商户入账时间有多长？
我有一笔POS机联系迟迟不到账	POS商户入账时间有多长？
成功交易，多久入账	POS商户入账时间有多长？
我是POS商户，银联何时给我入账	POS商户入账时间有多长？
你们银联有规定针对成功POS交易入账时间吗？	POS商户入账时间有多长？
POS入账时间多久	POS商户入账时间有多长？
POS成功交易，多久入账	POS商户入账时间有多长？
我的账为什么这么长时间还没到账？	POS商户入账时间有多长？
别人在我这刷卡，我怎么还没有收到钱？	POS商户入账时间有多长？
别人刷卡，我怎么还没有收到钱	POS商户入账时间有多长？
昨天的交易，怎么还没到账昨天刷卡，今天能到账吗	POS商户入账时间有多长？
我的POS机具坏了，你们赶紧派人来维修	我的POS机具坏了，你们赶紧派人来维修。
POS机退掉怎么退	我的POS机具坏了，你们赶紧派人来维修。
POS机用不了	我的POS机具坏了，你们赶紧派人来维修。
银联POS机可以过户吗	我的POS机具坏了，你们赶紧派人来维修。
我有个POS机不用了，押金怎么退？	我的POS机具坏了，你们赶紧派人来维修。
POS机撤机	我的POS机具坏了，你们赶紧派人来维修。
我要退POS机	我的POS机具坏了，你们赶紧派人来维修。
我的POS机用不了了	我的POS机具坏了，你们赶紧派人来维修。
想问一下现在我店不开了POS机怎么退？	我的POS机具坏了，你们赶紧派人来维修。
如何办理取消POS业务	我的POS机具坏了，你们赶紧派人来维修。
我某个时间办的POS机現在不能用了怎么办？	我的POS机具坏了，你们赶紧派人来维修。
你好，请问POS机开不了机是怎么回事	我的POS机具坏了，你们赶紧派人来维修。
我原来的POS机坏了，请问打什么电话	我的POS机具坏了，你们赶紧派人来维修。
我的POS机出现存储记录已满，请先结算咋回事	我的POS机具坏了，你们赶紧派人来维修。
我的刷卡机无法签到	我的POS机具坏了，你们赶紧派人来维修。
我的POS机卡纸了	我的POS机具坏了，你们赶紧派人来维修。
我的刷卡机刷不了卡了	我的POS机具坏了，你们赶紧派人来维修。
我办了POS机，现在想退机	我的POS机具坏了，你们赶紧派人来维修。
如何查询POS机关联的银行账号	我的POS机具坏了，你们赶紧派人来维修。
你好，我的POS机一直消费冲正怎么回事？	我的POS机具坏了，你们赶紧派人来维修。
我的刷卡机坏了	我的POS机具坏了，你们赶紧派人来维修。
我们的刷卡机连不上网了	我的POS机具坏了，你们赶紧派人来维修。
报修POS机	我的POS机具坏了，你们赶紧派人来维修。
我要报修POS机	我的POS机具坏了，你们赶紧派人来维修。
POS机不能用了	我的POS机具坏了，你们赶紧派人来维修。
POS机出现故障了	我的POS机具坏了，你们赶紧派人来维修。
POS故障	我的POS机具坏了，你们赶紧派人来维修。
我POS机签到不了，为什么？	我的POS机具坏了，你们赶紧派人来维修。
POS机具的操作员号是什么	我的POS机具坏了，你们赶紧派人来维修。
POS机怎么签到	我的POS机具坏了，你们赶紧派人来维修。
POS坏了	我的POS机具坏了，你们赶紧派人来维修。
POS坏了肿么办	我的POS机具坏了，你们赶紧派人来维修。
我想问一下，签到结算刷卡都操作不了，怎么办？	我的POS机具坏了，你们赶紧派人来维修。
刷卡机怎么刷不了	我的POS机具坏了，你们赶紧派人来维修。
你好，我公司原来开通的POS机，中间有段时间未使用，现在使用不了，是什么原因	我的POS机具坏了，你们赶紧派人来维修。
你好POS机的时间不对联系哪里设置呢	我的POS机具坏了，你们赶紧派人来维修。
我的中国银联POS机今天怎么签到不了	我的POS机具坏了，你们赶紧派人来维修。
我的刷卡机不工作	我的POS机具坏了，你们赶紧派人来维修。
我想安装一台POS机，该找哪里？	我想安装一台POS机，该找哪里？
银联POS汇率	我想安装一台POS机，该找哪里？
请问某地区办理银联POS机在哪里？	我想安装一台POS机，该找哪里？
你好我问一下安装P<数字>S机要押金吗	我想安装一台POS机，该找哪里？
你好我问一下安装POS机要押金吗	我想安装一台POS机，该找哪里？
你好，你们现在有没有办理移动POS机	我想安装一台POS机，该找哪里？
办理POS机	我想安装一台POS机，该找哪里？
办POS机	我想安装一台POS机，该找哪里？
请问你们公司有办理POS机业务吗	我想安装一台POS机，该找哪里？
现在有上门办POS机的吗	我想安装一台POS机，该找哪里？
在哪里可以办POS机	我想安装一台POS机，该找哪里？
有推销POS机的，自称是银联的。如何判断它的真实性？	我想安装一台POS机，该找哪里？
申POS要什么条件	我想安装一台POS机，该找哪里？
想代理刷卡机	我想安装一台POS机，该找哪里？
移动POS机办理	我想安装一台POS机，该找哪里？
某地办POS机的联系电话是？	我想安装一台POS机，该找哪里？
（你好）我想了解一下银联POS机	我想安装一台POS机，该找哪里？
你好，我想办移动POS机，怎么办理，在哪里办	我想安装一台POS机，该找哪里？
安装刷卡机	我想安装一台POS机，该找哪里？
怎么申请POS机	我想安装一台POS机，该找哪里？
我想办移动POS机.怎么办理	我想安装一台POS机，该找哪里？
请问现在银联有没有一种刷卡机是不用固定地点刷信用卡的	我想安装一台POS机，该找哪里？
你好，在某地如何申领办理移动POS机	我想安装一台POS机，该找哪里？
某地POS机上哪里退	我想安装一台POS机，该找哪里？
请问个体工商户可以办理POS机吗	我想安装一台POS机，该找哪里？
办理POS	我想安装一台POS机，该找哪里？
石家庄POS机上哪里退	我想安装一台POS机，该找哪里？
装POS机的具体费用，以及流程	我想安装一台POS机，该找哪里？
我想咨询POS机怎么装的	我想安装一台POS机，该找哪里？
装刷卡机要什么手续	我想安装一台POS机，该找哪里？
刷卡机怎么装	我想安装一台POS机，该找哪里？
申请POS机	我想安装一台POS机，该找哪里？
你们可以帮我装一台POS机吗	我想安装一台POS机，该找哪里？
在哪里申请POS机？	我想安装一台POS机，该找哪里？
怎么安装POS机？	我想安装一台POS机，该找哪里？
个人可以办理POS机吗？	我想安装一台POS机，该找哪里？
某POS机，是你们公司在做吗	我想安装一台POS机，该找哪里？
即时到账POS机，移动的，多少钱	我想安装一台POS机，该找哪里？
银联POS机办理需要多少钱？	我想安装一台POS机，该找哪里？
有人以中国银联商务中心的名义给我打电话说办理POS机，是真的吗	我想安装一台POS机，该找哪里？
你们公司是不是有买POS即办信用卡的啊	我想安装一台POS机，该找哪里？
银联POS机收费么	我想安装一台POS机，该找哪里？
请问某地的银联POS机服务电话号码是多少	我想安装一台POS机，该找哪里？
请问一下贵公司有移动支付POS机吗	我想安装一台POS机，该找哪里？
POS机可以办吗	我想安装一台POS机，该找哪里？
刷卡机办理	我想安装一台POS机，该找哪里？
办理POS机需要什么手续资料	我想安装一台POS机，该找哪里？
我的POS机能刷VISA卡/万事达卡吗？	我的POS机能刷VISA卡万事达卡吗？
我想增加刷外卡功能？	我的POS机能刷VISA卡万事达卡吗？
POS机上面能不能开通刷外卡功能？	我的POS机能刷VISA卡万事达卡吗？
我的POS机能刷JCB卡吗？	我的POS机能刷VISA卡万事达卡吗？
你们银联哪个部门可申请开通外卡功能？	我的POS机能刷VISA卡万事达卡吗？
如何在POS机上面开通外卡功能？	我的POS机能刷VISA卡万事达卡吗？
我的POS机能刷VISA卡吗？	我的POS机能刷VISA卡万事达卡吗？
我的刷卡机能刷外卡吗？	我的POS机能刷VISA卡万事达卡吗？
我的刷卡机能刷维萨卡吗？	我的POS机能刷VISA卡万事达卡吗？
VISA卡能在我们这个刷吗？	我的POS机能刷VISA卡万事达卡吗？
刷VISA卡，我们能正常收到钱吗？	我的POS机能刷VISA卡万事达卡吗？
卡面没有银联标志的卡可以刷吗？	我的POS机能刷VISA卡万事达卡吗？
我的POS机能刷万事达卡吗？	我的POS机能刷VISA卡万事达卡吗？
请帮我开通刷外卡的功能	我的POS机能刷VISA卡万事达卡吗？
客户的卡上只有万事达的标识，能刷吗？	我的POS机能刷VISA卡万事达卡吗？
POS机能刷外卡吗？	我的POS机能刷VISA卡万事达卡吗？
我的POS机怎么增加缴费功能？	我的POS机怎么增加缴费功能？
怎么样可以让我的刷卡机能缴费	我的POS机怎么增加缴费功能？
我的刷卡机能交水电煤吗？	我的POS机怎么增加缴费功能？
我们的机器能交账单吗？怎么开通	我的POS机怎么增加缴费功能？
刷卡机怎么加载缴费功能	我的POS机怎么增加缴费功能？
刷卡机怎么加装其他功能	我的POS机怎么增加缴费功能？
POS机上面能不能增加缴费功能？	我的POS机怎么增加缴费功能？
我想增加POS机的缴费功能，如何操作？	我的POS机怎么增加缴费功能？
你们银联哪个部门可申请在POS机上增加缴费功能?	我的POS机怎么增加缴费功能？
如何在POS机上面开通缴费功能？	我的POS机怎么增加缴费功能？
POS机怎么增加缴费功能？	我的POS机怎么增加缴费功能？
POS机具如何添加增值性功能？	我的POS机怎么增加缴费功能？
POS机如何开通分期付款业务？	POS机如何开通分期付款业务？
刷卡机怎么做分期	POS机如何开通分期付款业务？
刷卡机做分期付款，怎么操作	POS机如何开通分期付款业务？
要做分期付款怎么操作机具	POS机如何开通分期付款业务？
刷卡机的分期付款业务如何开通	POS机如何开通分期付款业务？
我想在我的POS机上面开通分期付款业务，如何申请？	POS机如何开通分期付款业务？
POS机上面开通分期付款业务，需要联系哪个部门？	POS机如何开通分期付款业务？
打什么电话可申请在我的POS机上面开通分期付款业务？	POS机如何开通分期付款业务？
POS机上是否可以开通分期付款业务？	POS机如何开通分期付款业务？
如何在POS机上开通分期付款业务？	POS机如何开通分期付款业务？
客户想使用信用卡分期付款，我该怎么操作？	POS机如何开通分期付款业务？
我的POS机能操作分期付款吗？	POS机如何开通分期付款业务？
如何开通分期付款	POS机如何开通分期付款业务？
帮我查一下交易明细	帮我查一下交易明细。
你能帮我查一下我们公司的刷卡机的明细吗	帮我查一下交易明细。
POS机怎么查询前一日的所有消费	帮我查一下交易明细。
POS机给冻结了，怎么才能解封，我的钱什么时候打过来？	帮我查一下交易明细。
你好我的POS机被冻结了怎么办	帮我查一下交易明细。
<数字>.<数字>.<数字>号<数字>消费<数字>查询明细	帮我查一下交易明细。
今天做结算后的金额和白天的交易签购单对不上怎么办	帮我查一下交易明细。
POS机结算之后怎么补打交易小票	帮我查一下交易明细。
请问怎么查POS机上前一天的流水	帮我查一下交易明细。
我是银联商户，我想查一下刚才的一笔交易有没有成功	帮我查一下交易明细。
你好请问我能查消费明细么？	帮我查一下交易明细。
哪里可以拉交易明细单	帮我查一下交易明细。
交易明细在哪儿打印	帮我查一下交易明细。
我要对账，帮我看一下明细？	帮我查一下交易明细。
要求对账，帮我查询一下明细	帮我查一下交易明细。
我怎样才能知道我POS机近期的交易情况？	帮我查一下交易明细。
我是商户，帮我查下交易明细	帮我查一下交易明细。
请帮我查询一笔交易信息	请帮我查询一笔交易信息
我要查<数字>年<数字>月<数字>日信用卡的交易地址	请帮我查询一笔交易信息
我要查某年某月某日信用卡的交易地址	请帮我查询一笔交易信息
我想查一下我的卡<数字>月<数字>号有笔银联消费地址是哪	请帮我查询一笔交易信息
可以查我在哪消费的吗？	请帮我查询一笔交易信息
银行卡上有一笔交易，给我看一下在哪里发生的	请帮我查询一笔交易信息
我要查某月某号的消费记录	请帮我查询一笔交易信息
我要查某月某日的消费记录	请帮我查询一笔交易信息
请问我有一笔钱不知道怎么消费的可以查询吗	请帮我查询一笔交易信息
能不能帮助查询POS机商户代码	请帮我查询一笔交易信息
今天早上我刷了一笔能查到在哪里刷卡的吗？	请帮我查询一笔交易信息
我需要查询这笔****年*月*日**元是怎么消费的	请帮我查询一笔交易信息
你好我要查询我的交易记录	请帮我查询一笔交易信息
帮我查一下，我没有用卡怎么来的这笔交易。	请帮我查询一笔交易信息
我想看一下我某天的交易明细	请帮我查询一笔交易信息
我想查一下**年*月银联的消费怎么查	请帮我查询一笔交易信息
是否能查询银行卡在哪取得钱	请帮我查询一笔交易信息
可以查到消费去向么	请帮我查询一笔交易信息
我想查询一下最后一笔消费	请帮我查询一笔交易信息
怎样查询在哪儿刷的POS机	请帮我查询一笔交易信息
查询POS机编码	请帮我查询一笔交易信息
我想问问我的银行卡无端消费了**元怎么回事	请帮我查询一笔交易信息
你好，请帮我查一下尾号****在那个/哪个银行取走钱。	请帮我查询一笔交易信息
我想查询某个时间的取款地点	请帮我查询一笔交易信息
你好，我银行卡里少了<数字>.<数字>元是怎么回事	请帮我查询一笔交易信息
你好我想查一下*月*号我的卡怎么消费了**块钱	请帮我查询一笔交易信息
这里可以查询交易吗？	请帮我查询一笔交易信息
怎样查询交易记录	请帮我查询一笔交易信息
能查收单机构吗	请帮我查询一笔交易信息
我想查我银行卡POS机刷卡的消费记录，能查吗？	请帮我查询一笔交易信息
怎么查询到我的银行卡在哪个地区消费的	请帮我查询一笔交易信息
我想查一下最近本人一笔**元的交易记录	请帮我查询一笔交易信息
转账情况怎么查	请帮我查询一笔交易信息
我银联卡上有一笔扣款，帮我查一下在哪里发生的？	请帮我查询一笔交易信息
我<数字>号有一笔钱支出了	请帮我查询一笔交易信息
麻烦您能否帮我查询一下<数字>月<数字>号在ATM机上交易的记录，还有就是在哪个城市取款的，我钱被盗了	请帮我查询一笔交易信息
我的银行卡刚刚不知道怎么被扣了<数字>元	请帮我查询一笔交易信息
我突然被刷了<数字>块钱	请帮我查询一笔交易信息
我的卡突然被消费了	请帮我查询一笔交易信息
帮我查一下昨天下午我卡里钱被盗了九千，被转到哪里去了	请帮我查询一笔交易信息
我有一个消费账单，自己也不知道，少了<数字>	请帮我查询一笔交易信息
刚刚扣了一笔款，是做什么的呢？	请帮我查询一笔交易信息
我的工商卡今天银联支出一百多，可是我并没有使用我的卡来付款啊	请帮我查询一笔交易信息
我想查今天交易，不知道为什么银联扣款	请帮我查询一笔交易信息
请问我<数字>.<数字>的消费是什么情况？	请帮我查询一笔交易信息
我没有消费为什么卡里少了<数字>元	请帮我查询一笔交易信息
在不，我的卡无缘无故被刷了怎么回事	请帮我查询一笔交易信息
你好，我的银行卡在今天<数字>：<数字>的时候扣了两笔费	请帮我查询一笔交易信息
我要查询一笔消费	请帮我查询一笔交易信息
为什么你们会扣我的钱，还什么保险业务	请帮我查询一笔交易信息
你好？我的卡被人扣费，费用不知道从哪里来的？我要查明从那里扣除的？	请帮我查询一笔交易信息
我在家乐福刷卡，已经扣款了，但是没有那笔交易明细？是什么问题？	请帮我查询一笔交易信息
我没有交易过怎么会自动扣款	请帮我查询一笔交易信息
我卡里面的钱为什么自动转走了？	请帮我查询一笔交易信息
我的卡被人扣费，我要查明从那里扣除的？	请帮我查询一笔交易信息
我卡上的钱被盗了怎么办？	请帮我查询一笔交易信息
我的钱被盗了<数字>块	请帮我查询一笔交易信息
我的某银行卡今天银联支出<数字>元，可是我并没有使用我的卡来付款啊	请帮我查询一笔交易信息
麻烦您能否帮我查询一下某月某号在ATM机上交易的记录，还有就是在哪个城市取款的，我钱被盗了	请帮我查询一笔交易信息
你好，我在一台手刷上面刷卡，已经扣款了，但是手刷没有我那笔交易明细？是什么问题？	请帮我查询一笔交易信息
我的卡被扣<数字>元想弄明白	请帮我查询一笔交易信息
<数字>左右转了<数字>万块钱，怎么到现在也没紧张。	请帮我查询一笔交易信息
我需要查询今天早上的一笔<数字>元的交易明细	请帮我查询一笔交易信息
我想查一下我的银行卡转账成功你了吗	请帮我查询一笔交易信息
帮我查询一下，我的邮政银行被消费<数字>块钱是怎么回事？	请帮我查询一笔交易信息
我的卡有五笔不明交易,能帮我查一下嘛	请帮我查询一笔交易信息
我想查一下刚刚我有一笔消费	请帮我查询一笔交易信息
我卡平白无故就少了十元钱、卡在我身上、但是来短信说我是POS消费	请帮我查询一笔交易信息
想查询<数字>交易,<数字>月<数字>日金额<数字>元	请帮我查询一笔交易信息
我想问哈<数字>点<数字>分银联扣款<数字>是怎么会事情	请帮我查询一笔交易信息
被无故扣钱是什么回事呢	请帮我查询一笔交易信息
我卡号<数字>于<数字>年<数字>月<数字>日被异地取款请帮我查下取款地址	请帮我查询一笔交易信息
你好，请问一下，<数字>,<数字>,<数字>我的卡扣了<数字>元，是消费去哪里的	请帮我查询一笔交易信息
你这边能帮我查询一下吗？<数字>	请帮我查询一笔交易信息
请问为什么突然扣我钱	请帮我查询一笔交易信息
我有一张信用卡在<数字>月<数字>号在银联商户刷了<数字>元，我想查询一下商户的地址	请帮我查询一笔交易信息
我有一张借记卡在<数字>月<数字>日在某商户刷了<数字>元，我想查询一下商户的地址	请帮我查询一笔交易信息
查POS消费	请帮我查询一笔交易信息
我的卡在身上，昨天有人在POS机上消费了我的金额	请帮我查询一笔交易信息
终端号查询	请帮我查询一笔交易信息
我问下我的卡里钱在什么地方取岀去的	请帮我查询一笔交易信息
帮我查一下今天有一条消费<数字>元是什么费用，我今天没有刷卡	请帮我查询一笔交易信息
我想问一下，我的银行卡今天早上莫名的消费了一笔金额，你能帮我查一下是什么吗？	请帮我查询一笔交易信息
帮我查一下我的银行卡无缘无故少了<数字>多元	请帮我查询一笔交易信息
可以帮我查一下我的银联卡的消费情况吗？	请帮我查询一笔交易信息
如果我的银行卡在一家POS机上刷了，可以查到刷卡地点么	请帮我查询一笔交易信息
如果我的银行卡在一家POS机上刷了，怎么查询刷卡地址	请帮我查询一笔交易信息
我想查下我的某行卡怎么莫名其妙被扣了<数字>块的钱	请帮我查询一笔交易信息
我有一张卡，从<数字>月份开始，隔几天有一笔<数字>元的代扣	请帮我查询一笔交易信息
我想查看个人的资金去向能查看吗	请帮我查询一笔交易信息
我的卡某天有两笔出账不是我消费的啊	请帮我查询一笔交易信息
我要查询交易记录怎么查	请帮我查询一笔交易信息
我想查我的卡是在哪刷的，怎么查	请帮我查询一笔交易信息
交易失败<数字>[<数字>]	<数字>
如何关闭小额免签免密？	如何关闭小额免签免密？
带有闪付功能信用卡<数字>元内刷卡免密能否取消	如何关闭小额免签免密？
如何取消小额免密免签	如何关闭小额免签免密？
你好，我想问怎么关闭银联卡的双免功能	如何关闭小额免签免密？
小额免密免签怎么关闭	如何关闭小额免签免密？
小额免密可以关吗？	如何关闭小额免签免密？
我要关掉小额免密（功能）	如何关闭小额免签免密？
如何关闭“银联联机闪付小额免密免签”功能？	如何关闭小额免签免密？
咨询某终端有没有通过银联认证	咨询某终端有没有通过银联认证
我刚办了一个POS机，想查下是你们银联的吗	咨询某终端有没有通过银联认证
有哪些刷卡器是银联认证的	咨询某终端有没有通过银联认证
乐刷POS机是正规的吗？	咨询某终端有没有通过银联认证
请问盒子支付POS机是正规银联支付牌照的吗	咨询某终端有没有通过银联认证
帮我查一下这个POS机有没有通过银联认证	某机构有没有接入银联，是否安全
ATM转账为什么要<数字>小时延迟到账？	ATM转账为什么要<数字>小时延迟到账？
跨省跨行转账多久能到	ATM转账为什么要<数字>小时延迟到账？
我想问下某银行ATM转账到某银行卡需要多长时间	ATM转账为什么要<数字>小时延迟到账？
请问由某银行转到某银行的钱什么时候能到账	ATM转账为什么要<数字>小时延迟到账？
我想咨询一下，某银行转账到某银行多久能到账	ATM转账为什么要<数字>小时延迟到账？
（就是）我今天下午做跨行转账为什么还没到账？？？	ATM转账为什么要<数字>小时延迟到账？
请问一下今天上午夸行转账到现在还没有到账是什么原因	ATM转账为什么要<数字>小时延迟到账？
请问一下今天上午跨行转账到现在还没有到账是什么原因	ATM转账为什么要<数字>小时延迟到账？
某银行取款机跨行转账要多久才到账	ATM转账为什么要<数字>小时延迟到账？
我想知道转账多久能到账	ATM转账为什么要<数字>小时延迟到账？
跨行转账几个工作日到账	ATM转账为什么要<数字>小时延迟到账？
银联卡异地跨行转账要多长时间到账	ATM转账为什么要<数字>小时延迟到账？
我被骗了，ATM转账能拦截吗	ATM转账为什么要<数字>小时延迟到账？
现在ATM转账是实时到帐吗	ATM转账为什么要<数字>小时延迟到账？
我刚刚在提款机上转了一笔钱现在还没有到账	ATM转账为什么要<数字>小时延迟到账？
想问一下，我通过ATM转了一笔钱什么时候能入账	ATM转账为什么要<数字>小时延迟到账？
为什么我用兰州银行跨行转账到现在没到账	ATM转账为什么要<数字>小时延迟到账？
为什么我某银行跨行转账到现在没到账	ATM转账为什么要<数字>小时延迟到账？
我们用的刷卡纸没了	我们用的刷卡纸没了
打印纸派送	我们用的刷卡纸没了
我想要银联打印纸要打那(哪)个电话	我们用的刷卡纸没了
刷卡机里的纸没了，可以快递给我吗？	我们用的刷卡纸没了
您好，请问热敏纸怎么样领取	我们用的刷卡纸没了
POS小票不够了从哪里定？	我们用的刷卡纸没了
银联POS机没有打印纸到什么地方领购	我们用的刷卡纸没了
我们POS打印纸没有了	我们用的刷卡纸没了
我需要POS刷卡纸	我们用的刷卡纸没了
我需要POS打印纸	我们用的刷卡纸没了
现在需要POS机的打印纸	我们用的刷卡纸没了
移动POS开机显示缺纸怎么办	我们用的刷卡纸没了
刷卡纸预定	我们用的刷卡纸没了
请问需要刷卡纸打哪个电话	我们用的刷卡纸没了
我需要订热敏纸	我们用的刷卡纸没了
请问商户打哪个电话要热敏纸	我们用的刷卡纸没了
请问POS机刷卡单子要没有了，打哪个电话	我们用的刷卡纸没了
我的移动POS机的纸没有了，请问哪里可以订？	我们用的刷卡纸没了
需要定纸移动POS机里没有纸了，可以订嘛？	我们用的刷卡纸没了
POS机没纸了，给我送纸。	我们用的刷卡纸没了
签购单中奖查询	签购单中奖查询
我银行卡不小心被锁了怎么办	我银行卡不小心被锁了怎么办
我银联卡被冻结怎么回事	我银行卡不小心被锁了怎么办
为什么我开通的短信业务没有短信？	我银行卡不小心被锁了怎么办
我想办理信用卡	我银行卡不小心被锁了怎么办
中国旅游卡收年费吗	我银行卡不小心被锁了怎么办
某某卡收年费吗？	我银行卡不小心被锁了怎么办
什么是预授权	什么是预授权
哪些情况下可以向银行申请撤销转账？	哪些情况下可以向银行申请撤销转账？
你好，我通过ATM跨行转账的交易可以撤销吗	哪些情况下可以向银行申请撤销转账？
怎么向银行申请撤销转账？	哪些情况下可以向银行申请撤销转账？
转账撤销需要提供哪些材料或证明？	哪些情况下可以向银行申请撤销转账？
怎么申请转账撤销	哪些情况下可以向银行申请撤销转账？
做了预授权后，资金什么时候返还	做了预授权后，资金什么时候返还
预授权有效期多久？	做了预授权后，资金什么时候返还
预授权有效期多少天？	做了预授权后，资金什么时候返还
预授权有有效期吗？	做了预授权后，资金什么时候返还
预授权有效期多久	做了预授权后，资金什么时候返还
你好，想咨询一下如果之前预授权冻结了<数字>元，后完成预授权<数字>元，剩余的钱什么时候还到卡上	做了预授权后，资金什么时候返还
想咨询一下如果之前预授权冻结了X元，后完成预授权X元，剩余的钱什么时候返到卡上	做了预授权后，资金什么时候返还
我*月*号有一笔预授权怎么没有退还	做了预授权后，资金什么时候返还
您好，我想问下我某月某号在某地刷的POS机，交了商品押金，之后押金一直未到帐，怎么回事	做了预授权后，资金什么时候返还
我的卡上资金被冻结<数字>个多月，不知道怎么解冻？	做了预授权后，资金什么时候返还
为什么支付页面显示的不是中文？	为什么支付页面显示的不是中文？
页面可以换成全中文吗？	为什么支付页面显示的不是中文？
我的电脑显示的是英文版的，怎么换成中文版的	为什么支付页面显示的不是中文？
如何切换支付页面显示英文版	为什么支付页面显示的不是中文？
支付页面有没有繁体中文版	为什么支付页面显示的不是中文？
支付页面有没有英文版	为什么支付页面显示的不是中文？
支付页面如何切换繁体字	为什么支付页面显示的不是中文？
支付页面有没有其他语言版本	为什么支付页面显示的不是中文？
页面为什么不是中文	为什么支付页面显示的不是中文？
页面怎么改成中文	为什么支付页面显示的不是中文？
网上支付时怎么出现了英文界面？	为什么支付页面显示的不是中文？
为什么支付界面是英文版的？	为什么支付页面显示的不是中文？
我在支付商品，然后全是英文看不懂	为什么支付页面显示的不是中文？
付款界面是英语的怎么办？	为什么支付页面显示的不是中文？
付款界面怎么换成中文的？	为什么支付页面显示的不是中文？
支付页面支持哪些语言	为什么支付页面显示的不是中文？
支付页面为什么显示英文？	为什么支付页面显示的不是中文？
支付页面如何切换语言？	为什么支付页面显示的不是中文？
支付页面如何切换成中文？	为什么支付页面显示的不是中文？
为什么支付页面不是中文的？	为什么支付页面显示的不是中文？
目前在哪些商户网站上可以使用银联在线支付？	目前在哪些商户网站上可以使用银联在线支付？
银联在线支付的商户信息哪里有	目前在哪些商户网站上可以使用银联在线支付？
京东是银联在线支付的商户吗？	目前在哪些商户网站上可以使用银联在线支付？
哪些网站可以用银联在线支付？	目前在哪些商户网站上可以使用银联在线支付？
哪些商户是跟你们银联在线支付合作的？	目前在哪些商户网站上可以使用银联在线支付？
我已经开通了银联在线支付，我可以在哪里支付？	目前在哪些商户网站上可以使用银联在线支付？
我在哪里能找到可以用银联在线支付的商户？	目前在哪些商户网站上可以使用银联在线支付？
支持银联在线支付的商户有哪些？	目前在哪些商户网站上可以使用银联在线支付？
XX商户支持在线支付吗？	目前在哪些商户网站上可以使用银联在线支付？
哪些商户可以用银联在线支付？	目前在哪些商户网站上可以使用银联在线支付？
京东可以使用银联在线支付吗？	目前在哪些商户网站上可以使用银联在线支付？
京东支持银联在线支付吗？	目前在哪些商户网站上可以使用银联在线支付？
那些商户支持银联在线支付？	目前在哪些商户网站上可以使用银联在线支付？
目前哪些银行可以用于银联在线支付？	目前哪些银行可以用于银联在线支付？
我的卡怎么不支持在线支付	目前哪些银行可以用于银联在线支付？
我的银联卡怎么不支持在线支付？	目前哪些银行可以用于银联在线支付？
网银不能支付	目前哪些银行可以用于银联在线支付？
农业银行卡不能在线支付吗	目前哪些银行可以用于银联在线支付？
农业银行卡不能认证支付吗	目前哪些银行可以用于银联在线支付？
农业银行卡不能快捷支付吗	目前哪些银行可以用于银联在线支付？
农业银行卡不能无卡支付吗	目前哪些银行可以用于银联在线支付？
我用的是农信社（或农商行）卡，支持你们银联在线支付吗？	目前哪些银行可以用于银联在线支付？
不支持农业银行卡支付吗？	目前哪些银行可以用于银联在线支付？
银联在线支付的支持银行有哪些？	目前哪些银行可以用于银联在线支付？
XX银行支持银联在线支付吗？	目前哪些银行可以用于银联在线支付？
工行卡可以使用银联在线支付吗？	目前哪些银行可以用于银联在线支付？
工行支持银联在线支付吗？	目前哪些银行可以用于银联在线支付？
工商银行支持银联在线支付吗？	目前哪些银行可以用于银联在线支付？
工商银行卡可以使用银联在线支付吗？	目前哪些银行可以用于银联在线支付？
银行卡没开通网上支付可以认证吗	如何开通银联在线支付？
在哪申请银行卡网银支付	如何开通银联在线支付？
怎么开通支付功能	如何开通银联在线支付？
银行卡开通银联	如何开通银联在线支付？
您好，为什么我的银行卡未开通认证支付功能是什么意思？	如何开通银联在线支付？
银联开通链接	如何开通银联在线支付？
如何开通银联在线功能呢？请问。	如何开通银联在线支付？
你好，请问怎么开通银联支付功能	如何开通银联在线支付？
开通在线支付功能	如何开通银联在线支付？
银联无卡支付在哪里办理	如何开通银联在线支付？
我这边怎么申请银联通道？	如何开通银联在线支付？
麻烦把那个开通银联的网址发一下吧	如何开通银联在线支付？
请问开通银联在线的入口是	如何开通银联在线支付？
银联在线支付的开通方式是什么？	如何开通银联在线支付？
银联快捷支付怎么认证	如何开通银联在线支付？
怎么开通支付认证	如何开通银联在线支付？
请发一个关于银联认证支付功能的链接。	如何开通银联在线支付？
能帮我开一下银联在线支付吗	如何开通银联在线支付？
自己能开通银联在线服务吗	如何开通银联在线支付？
银行卡支付认证怎么开通	如何开通银联在线支付？
银联在线支付功能开通网站多少	如何开通银联在线支付？
银联在线支付如何操作	如何开通银联在线支付？
银联无卡支付业务怎么开？	如何开通银联在线支付？
开通银联卡网上支付的步骤	如何开通银联在线支付？
银联在线支付开通	如何开通银联在线支付？
怎么开银联支付	如何开通银联在线支付？
在哪开银联在线支付啊	如何开通银联在线支付？
怎么开在线支付	如何开通银联在线支付？
你好我想开无卡支付业务	如何开通银联在线支付？
开通认证支支付	如何开通银联在线支付？
XX银行卡如何开通银联认真支付功能？	如何开通银联在线支付？
怎么开银联在线支付	如何开通银联在线支付？
在线支付开通	如何开通银联在线支付？
在线支付链接	如何开通银联在线支付？
想问下，在线支付的链接给我下好么	如何开通银联在线支付？
如何办理银联无卡支付	如何开通银联在线支付？
银联在线支付开通条件是什么	如何开通银联在线支付？
银行网站可以直接开通银联在线支付吗	如何开通银联在线支付？
我想开通银联在线支付	如何开通银联在线支付？
开通银联在线支付	如何开通银联在线支付？
我要开通银联支付，发个网址	如何开通银联在线支付？
怎么开通银联认证支付功能？	如何开通银联在线支付？
开通在线功能	如何开通银联在线支付？
XX银行如何开通银联在线支付？	如何开通银联在线支付？
开通银联在线支付有什么要求吗？	如何开通银联在线支付？
怎么开通银联无卡支付？	如何开通银联在线支付？
如何开通银联在线支付？	如何开通银联在线支付？
在线支付怎么开通？	如何开通银联在线支付？
开通在线支付	如何开通银联在线支付？
你好，我的卡要网付<数字>W，但是现在和我说超过限额	银联在线支付的支付限额是什么？
台州银行的信用卡线上支付限额可以更改吗	银联在线支付的支付限额是什么？
南京银行卡超出限额是什么原因？	银联在线支付的支付限额是什么？
输入卡号后说此卡单次支付默认限额<数字>元，什么意思，我好像没设这个限额的	银联在线支付的支付限额是什么？
这个建设日限制多少	银联在线支付的支付限额是什么？
银联在线支付的支付限额是什么？	银联在线支付的支付限额是什么？
银联网上交易限额是多少	银联在线支付的支付限额是什么？
银联限额是多少	银联在线支付的支付限额是什么？
请问银联支付的限额是多少？	银联在线支付的支付限额是什么？
请问银联使用银行卡支付有限额吗	银联在线支付的支付限额是什么？
麻烦问一下、金额超限是啥意思、已经弄好几次了	银联在线支付的支付限额是什么？
怎么修改支付限额	银联在线支付的支付限额是什么？
超出支付限额怎么办	银联在线支付的支付限额是什么？
请问支付受到限额限制怎么办	银联在线支付的支付限额是什么？
我支付金额超额度是怎么回事	银联在线支付的支付限额是什么？
银联在线支付有交易金额限制吗	银联在线支付的支付限额是什么？
银联在线支付交易报错超限，怎么办	银联在线支付的支付限额是什么？
我用银联在线支付，最大可以支付多少？	银联在线支付的支付限额是什么？
我要支付一笔超过<数字>元的订单，用银联在线支付可以吗？	银联在线支付的支付限额是什么？
为什么在线支付时提示订单金额超过了？	银联在线支付的支付限额是什么？
有支付限额吗？	银联在线支付的支付限额是什么？
XX商户限额多少？	银联在线支付的支付限额是什么？
京东商城的限额是多少？	银联在线支付的支付限额是什么？
京东商城有限额吗？	银联在线支付的支付限额是什么？
工行银联在线支付的限额是多少？	银联在线支付的支付限额是什么？
开通网上支付功能是否需要支付手续费？	开通网上支付功能是否需要支付手续费？
开通在线支付要钱吗	开通网上支付功能是否需要支付手续费？
开通银联在线支付要年费吗？	开通网上支付功能是否需要支付手续费？
开通银联在线支付是免费的吗？	开通网上支付功能是否需要支付手续费？
开通在线支付是否需要付费？	开通网上支付功能是否需要支付手续费？
开通银联在线支付付款需要手续费吗？	开通网上支付功能是否需要支付手续费？
开通在线支付收费吗？	开通网上支付功能是否需要支付手续费？
开通银联无卡支付收费吗？	开通网上支付功能是否需要支付手续费？
开通无卡支付收费吗？	开通网上支付功能是否需要支付手续费？
银联在线支付的费率多少呢	进行网上交易是否需要支付手续费？
银联支付的费率是多少呢	进行网上交易是否需要支付手续费？
进行网上交易是否需要支付手续费？	进行网上交易是否需要支付手续费？
银联在线支付收多少个点？	进行网上交易是否需要支付手续费？
银联在线支付交易是否需要额外的费用	进行网上交易是否需要支付手续费？
银联网上支付交易是否需要额外的费用	进行网上交易是否需要支付手续费？
我通过银联在线支付付款，会不会产生额外的费用？	进行网上交易是否需要支付手续费？
在线支付交易是否需要付费？	进行网上交易是否需要支付手续费？
银联在线支付有手续费吗？	进行网上交易是否需要支付手续费？
银联在线支付收费吗？	进行网上交易是否需要支付手续费？
我使用银联网上消费，你们要收多少手续费？	进行网上交易是否需要支付手续费？
我网上消费，你们要收多少手续费？	进行网上交易是否需要支付手续费？
如何关闭银联在线支付？	如何关闭银联在线支付？
怎么解除银联在线支付	如何关闭银联在线支付？
银行网站可以直接关闭银联在线支付吗	如何关闭银联在线支付？
我在支付时开通了银联支付，怎么关闭？	如何关闭银联在线支付？
银联支付在哪里可以关闭？	如何关闭银联在线支付？
开通银联在线支付后怎么关闭？	如何关闭银联在线支付？
银联在线支付可以关闭吗？	如何关闭银联在线支付？
怎么关闭银联在线支付？	如何关闭银联在线支付？
怎么关闭银联无卡支付？	如何关闭银联在线支付？
如何自助查询交易？	如何自助查询交易？
请问一下，我的商户订单号是多少？	如何自助查询交易？
你好我想查询订单号	如何自助查询交易？
能帮我查个订单号吗	如何自助查询交易？
我的农行卡上经常有银联在线支付，是怎么回事？	如何自助查询交易？
我想问一下我一个订单有没有付款	如何自助查询交易？
查询银联在线支付电子回单	如何自助查询交易？
如何查询网上交易	如何自助查询交易？
什么网站可以直接查询交易信息	如何自助查询交易？
微信可以查询交易信息吗	如何自助查询交易？
网上查询交易的步骤是什么	如何自助查询交易？
怎么查询银联在线支付明细？	如何自助查询交易？
我网上支付了，怎么看一下成不成功？	如何自助查询交易？
我有一笔交易显示银联在线支付的，我想查一下支付去哪儿了	如何自助查询交易？
我在网上支付，银行卡扣款了，但商户显示未支付，怎么办？	如何自助查询交易？
如何查询网上的交易记录？	如何自助查询交易？
怎么查询银联在线支付交易？	如何自助查询交易？
网站上可以查询银联在线支付交易吗？	如何自助查询交易？
如何查询商户订单号？	如何自助查询交易？
我可以通过网站查询交易吗？	如何自助查询交易？
页面提示：非法请求：请确认从有效界面进入，该怎么办？	页面提示：非法请求：请确认从有效界面进入，该怎么办？
什么是有效界面	页面提示：非法请求：请确认从有效界面进入，该怎么办？
如何通过有效界面进入进行交易	页面提示：非法请求：请确认从有效界面进入，该怎么办？
我正常交易，怎么会是非法请求呢	页面提示：非法请求：请确认从有效界面进入，该怎么办？
提示非法请求	页面提示：非法请求：请确认从有效界面进入，该怎么办？
为什么会提示非法请求？	页面提示：非法请求：请确认从有效界面进入，该怎么办？
非法请求：请确认从有效界面进入，该怎么办？	页面提示：非法请求：请确认从有效界面进入，该怎么办？
页面提示：非法请求，怎么办？	页面提示：非法请求：请确认从有效界面进入，该怎么办？
短信验证码发送多次被锁，怎么办？	短信验证码发送多次被锁，怎么办？
短信验证码被锁怎么办	短信验证码发送多次被锁，怎么办？
验证码被锁怎么办	短信验证码发送多次被锁，怎么办？
因为短信验证码有问题，账户被锁怎么办	短信验证码发送多次被锁，怎么办？
账户被锁了，核实能重新操作接收短信验证码	短信验证码发送多次被锁，怎么办？
因验证码被锁，要等多久	短信验证码发送多次被锁，怎么办？
之前获取了很多次短信验证码，现在获取不了了，说过段时间再试，怎么办？	短信验证码发送多次被锁，怎么办？
短信验证码提示发送频繁了，多久可以再发送？	短信验证码发送多次被锁，怎么办？
短信验证码可以获取几次？	短信验证码发送多次被锁，怎么办？
我收不到短信验证码了，说发送频繁，怎么办？	短信验证码发送多次被锁，怎么办？
短信验证码要是发送次数多，被锁了，多久可以解锁？	短信验证码发送多次被锁，怎么办？
无法再发送验证码了，怎么办？	短信验证码发送多次被锁，怎么办？
获取验证码提示超过次数怎么办？	短信验证码发送多次被锁，怎么办？
验证码提示获取频繁如何处理？	短信验证码发送多次被锁，怎么办？
为什么无法获取验证码，提示频繁？	短信验证码发送多次被锁，怎么办？
短信验证码输错多次，被锁了，怎么办？	短信验证码发送多次被锁，怎么办？
短信验证码输错多次，怎么办？	短信验证码发送多次被锁，怎么办？
提示频繁后验证码间隔多久可以再次获取？	短信验证码发送多次被锁，怎么办？
短信验证码的有效期是多少？	短信验证码有效期多久？？
验证码几分钟内有效	短信验证码有效期多久？？
<数字>分钟前收到的验证码还有效吗	短信验证码有效期多久？？
验证码多久会过期	短信验证码有效期多久？？
获取短信验证码后，多长时间内需要完成支付？	短信验证码有效期多久？？
短信验证码过多久会失效？	短信验证码有效期多久？？
我收到短信验证码了，可以在几分钟内完成支付？	短信验证码有效期多久？？
验证码的时效？	短信验证码有效期多久？？
验证码有有效时间吗？	短信验证码有效期多久？？
短信验证码多长时间有效？	短信验证码有效期多久？？
图片验证码和支付页面的有效时间是多少？	图片验证码和支付页面的有效时间是多少？
支付页面多长时间有效	图片验证码和支付页面的有效时间是多少？
支付页面几分钟内有效	图片验证码和支付页面的有效时间是多少？
图片验证码多长时间有效	图片验证码和支付页面的有效时间是多少？
图片验证码几分钟内有效	图片验证码和支付页面的有效时间是多少？
我在支付，跳转到支付页面后，需要在多长时间内完成支付？	图片验证码和支付页面的有效时间是多少？
我身边没带银行卡，不记得卡号，现在已经跳转到支付页面了，这个页面能保存多久？	图片验证码和支付页面的有效时间是多少？
如果我暂时不支付，支付页面能保持多久？	图片验证码和支付页面的有效时间是多少？
点击付款后，我应该在几分钟内完成支付？	图片验证码和支付页面的有效时间是多少？
多长时间内完成支付	图片验证码和支付页面的有效时间是多少？
支付页面保存多久	图片验证码和支付页面的有效时间是多少？
借记卡密码输错几次后会被锁定？会锁定多久？	借记卡密码输错几次后会被锁定？会锁定多久？
卡片支付时密码被锁怎么办	借记卡密码输错几次后会被锁定？会锁定多久？
工行卡支付时密码被锁怎么办	借记卡密码输错几次后会被锁定？会锁定多久？
如果我连续输错了几次取款密码，会怎么样？	借记卡密码输错几次后会被锁定？会锁定多久？
我之前记错银行卡密码了，输错了几次，现在没法支付了，过多久可以重新支付？	借记卡密码输错几次后会被锁定？会锁定多久？
密码输入错误多次被锁，怎么办？	借记卡密码输错几次后会被锁定？会锁定多久？
银行卡密码输入次数超限，需要等待多久？	借记卡密码输错几次后会被锁定？会锁定多久？
密码输错几次会锁住？	借记卡密码输错几次后会被锁定？会锁定多久？
密码输错<数字>次了，怎么办？	借记卡密码输错几次后会被锁定？会锁定多久？
密码被锁后多久会恢复？	借记卡密码输错几次后会被锁定？会锁定多久？
借记卡密码被锁定了，怎么办？	借记卡密码输错几次后会被锁定？会锁定多久？
密码输错多次了，被锁了，怎么办？	借记卡密码输错几次后会被锁定？会锁定多久？
网银支付过程报错“支付失败，密码错”，如何处理？	网银支付过程报错“支付失败，密码错”，如何处理？
支付报错，密码错	网银支付过程报错“支付失败，密码错”，如何处理？
交易提示：密码错，	网银支付过程报错“支付失败，密码错”，如何处理？
输得密码是对的，但一直提示密码错，怎么办	网银支付过程报错“支付失败，密码错”，如何处理？
为什么会返回：密码错	网银支付过程报错“支付失败，密码错”，如何处理？
密码错，不会扣钱吧	网银支付过程报错“支付失败，密码错”，如何处理？
我明明输入的就是网银密码，为啥还说密码错？	网银支付过程报错“支付失败，密码错”，如何处理？
网银密码到底是哪个，我输入正确的，还是说密码错	网银支付过程报错“支付失败，密码错”，如何处理？
支付失败，密码错，怎么办？	网银支付过程报错“支付失败，密码错”，如何处理？
网银支付，提示密码错误	网银支付过程报错“支付失败，密码错”，如何处理？
网银支付，支付失败，提示密码错误	网银支付过程报错“支付失败，密码错”，如何处理？
在银行端开通网上支付功能出错，该如何处理？	在银行端开通网上支付功能出错，该如何处理？
招行开通网上支付功能出错，怎么办	在银行端开通网上支付功能出错，该如何处理？
为什么开通网上支付功能会出错	在银行端开通网上支付功能出错，该如何处理？
我在开通网上银行功能，页面说错误，怎么办？	在银行端开通网上支付功能出错，该如何处理？
我在工商银行网银上开通支付功能，但提示信息错误，怎么处理？	在银行端开通网上支付功能出错，该如何处理？
我在招行网银没法开通支付功能，要怎么处理？	在银行端开通网上支付功能出错，该如何处理？
我想开通网上银行功能，但老是提示失败，帮我查一下是什么原因？	在银行端开通网上支付功能出错，该如何处理？
开通网银功能失败，该找谁？	在银行端开通网上支付功能出错，该如何处理？
为什么无法在银行里开通网上支付？	在银行端开通网上支付功能出错，该如何处理？
交易后如何退货？	交易后如何退货？
交易后如何退款？	交易后如何退货？
网上退货需要多久	交易后如何退货？
我要退货没网上可以办吗	交易后如何退货？
我在网上买了一样东西，但是有质量问题，我要怎么退货？	交易后如何退货？
我通过你们银联在线支付购买了一件货品，该怎么退货？	交易后如何退货？
我要退货，找哪里退？	交易后如何退货？
我想退款，怎么操作？	交易后如何退货？
如何办理退货？	交易后如何退货？
我要退货，如何操作？	交易后如何退货？
网上交易如何退货	交易后如何退货？
银联在线支付如何保证支付交易安全性？	银联在线支付如何保证支付交易安全性？
银联在线支付通过什么方法来确保交易安全？	银联在线支付如何保证支付交易安全性？
我在网上支付，安全吗？	银联在线支付如何保证支付交易安全性？
为什么在线支付要输入取款密码，第一次遇到这种情况，密码会不会泄漏？	银联在线支付如何保证支付交易安全性？
支付页面要求我输入取款密码，以前从来没有遇到过，是不是钓鱼网站？	银联在线支付如何保证支付交易安全性？
银联在线支付安全吗?	银联在线支付如何保证支付交易安全性？
支付有风险吗？	银联在线支付如何保证支付交易安全性？
为了保证网上支付安全，我还需要注意些什么呢？	为了保证网上支付安全，我还需要注意些什么呢？
银联在线支付安全注意事项有那些	为了保证网上支付安全，我还需要注意些什么呢？
我在网吧，我可以支付吗？安全吗？	为了保证网上支付安全，我还需要注意些什么呢？
有哪些细节我应该注意的，为了确保网上支付安全	为了保证网上支付安全，我还需要注意些什么呢？
我在网上支付，担心遇到钓鱼网站，我应该注意些什么呢？	为了保证网上支付安全，我还需要注意些什么呢？
网上交易，如何保证安全？	为了保证网上支付安全，我还需要注意些什么呢？
如何保证支付安全性？	为了保证网上支付安全，我还需要注意些什么呢？
网上支付有哪些注意事项呢？	为了保证网上支付安全，我还需要注意些什么呢？
支付页面，提示“该页无法显示”或空白页，如何处理？	支付页面，提示“该页无法显示”或空白页，如何处理？
显示空白页，怎么办	支付页面，提示“该页无法显示”或空白页，如何处理？
报错该页无法显示	支付页面，提示“该页无法显示”或空白页，如何处理？
该页无法显示	支付页面，提示“该页无法显示”或空白页，如何处理？
支付跳转空白页，怎么办	支付页面，提示“该页无法显示”或空白页，如何处理？
我点了付款，为什么总是出现页面错误，链接不过去	支付页面，提示“该页无法显示”或空白页，如何处理？
我在支付，点了下一步后，页面没有反应。	支付页面，提示“该页无法显示”或空白页，如何处理？
我已经填写所有的交易信息，点击开通并支付，但是没有反应，怎么办？	支付页面，提示“该页无法显示”或空白页，如何处理？
我正在网上付款，最后到确认付款的按钮按完没有反应。	支付页面，提示“该页无法显示”或空白页，如何处理？
页面没有反应	支付页面，提示“该页无法显示”或空白页，如何处理？
为什么我的支付页面是空白的？	支付页面，提示“该页无法显示”或空白页，如何处理？
页面无法显示怎么办？	支付页面，提示“该页无法显示”或空白页，如何处理？
支付页面无法显示怎么办？	支付页面，提示“该页无法显示”或空白页，如何处理？
支付页面（即支付网关）出现“使用立减券”的选项，如何操作？	支付页面（即支付网关）出现“使用立减券”的选项，如何操作？
如何获取和使用立减券	支付页面（即支付网关）出现“使用立减券”的选项，如何操作？
如何使用立减券	支付页面（即支付网关）出现“使用立减券”的选项，如何操作？
支付页面没有显示“立减券”选项，怎么办	支付页面（即支付网关）出现“使用立减券”的选项，如何操作？
使用立减券的选项在页面什么位置	支付页面（即支付网关）出现“使用立减券”的选项，如何操作？
我勾了立减券，让我输券码，从哪里可以获得券码？	支付页面（即支付网关）出现“使用立减券”的选项，如何操作？
立减券券码填什么？	支付页面（即支付网关）出现“使用立减券”的选项，如何操作？
立减券是什么意思？	支付页面（即支付网关）出现“使用立减券”的选项，如何操作？
如何获得立减券？	支付页面（即支付网关）出现“使用立减券”的选项，如何操作？
我银行预留的手机已变更，现在收不到验证码，该怎么办？	短信验证码接收异常如何处理？
短信验证码接收异常如何处理？	短信验证码接收异常如何处理？
我的短息验证为什么收不到	短信验证码接收异常如何处理？
不能接收验证码	短信验证码接收异常如何处理？
手机不能接受验证码	短信验证码接收异常如何处理？
没有收到短信验证	短信验证码接收异常如何处理？
没有收到验证短信	短信验证码接收异常如何处理？
收不到验证玛	短信验证码接收异常如何处理？
我的短信验证为什么收不到	短信验证码接收异常如何处理？
为什么我获取短信验证码的时候一直显示系统错误，重新尝试	短信验证码接收异常如何处理？
为什么手机显现不出验证码	短信验证码接收异常如何处理？
为什么验证码一直发送失败	短信验证码接收异常如何处理？
手机收不到验证短信	短信验证码接收异常如何处理？
接收不到短消息	短信验证码接收异常如何处理？
收不到短信	短信验证码接收异常如何处理？
为什么短信验证码发不到我手机上	短信验证码接收异常如何处理？
短信验证码多长时间会发到手机上	短信验证码接收异常如何处理？
我开通银联在线支付，为什么获取不了短信验证码？	短信验证码接收异常如何处理？
为什么我总收不到支付短信？	短信验证码接收异常如何处理？
短信验证码怎么等了很久还没有收到？	短信验证码接收异常如何处理？
为什么我收不到短信验证码？	短信验证码接收异常如何处理？
短信验证码收不到怎么办？	短信验证码接收异常如何处理？
怎么没给我发验证码？	短信验证码接收异常如何处理？
为什么<数字>S后还没发送验证码？	短信验证码接收异常如何处理？
点击获取验证码为什么没有反应？	短信验证码接收异常如何处理？
为什么不给我发短信验证码？	短信验证码接收异常如何处理？
银行工作人员如何查询银行卡交易情况？	银行工作人员如何查询银行卡交易情况？
想帮我们行的持卡人查交易明细，该如何处理	银行工作人员如何查询银行卡交易情况？
如何帮客户查询交易记录。	银行工作人员如何查询银行卡交易情况？
客户对对账单的交易有疑问，怎么办	银行工作人员如何查询银行卡交易情况？
客户用我们建行卡，发生交易差错怎么办？	银行工作人员如何查询银行卡交易情况？
客户账单上显示多扣钱了，怎么办？	银行工作人员如何查询银行卡交易情况？
我是银行工作人员，你可以帮我查询一下交易吗？	银行工作人员如何查询银行卡交易情况？
我要帮我们银行的持卡人查询交易，您可以帮我吗？	银行工作人员如何查询银行卡交易情况？
我要查询我行的交易	银行工作人员如何查询银行卡交易情况？
我是（发卡）银行，麻烦帮我查询一下这笔交易。	银行工作人员如何查询银行卡交易情况？
我是商户的收单银行、收单机构，帮我查询这笔交易等我情况。	银行工作人员如何查询银行卡交易情况？
银行如何查询银行卡交易？	银行工作人员如何查询银行卡交易情况？
如何做预授权完成？	如何做预授权完成？
预授权完成，又撤销后，原来的预授权还在吗？	如何做预授权完成？
我们帮客户做了预授权完成，还能撤销吗	如何做预授权完成？
怎么做预授权结算？	如何做预授权完成？
预授权结算？	如何做预授权完成？
什么是银联IC卡？	什么是银联IC卡？
<数字>IC卡是指带芯片的卡吗？	什么是银联IC卡？
IC卡闪付	什么是银联IC卡？
银联IC卡和磁条卡有什么区别	什么是银联IC卡？
银联IC卡具体是指什么？	什么是银联IC卡？
银联IC卡的含义是什么？	什么是银联IC卡？
IC卡有哪些优点？	IC卡有哪些优点？
银联IC卡和一般IC卡可有什么区别	IC卡有哪些优点？
芯片卡特点是什么？	IC卡有哪些优点？
IC卡特点是什么？	IC卡有哪些优点？
使用IC卡有什么好处？	IC卡有哪些优点？
为什么要使用IC卡？	IC卡有哪些优点？
IC卡有哪些类型？	IC卡有哪些类型？
银联IC卡有几种？都是借记卡吗？	IC卡有哪些类型？
银联IC卡与借记卡的区分	IC卡有哪些类型？
银联IC卡与借记卡的区别	IC卡有哪些类型？
IC卡怎么分的	IC卡有哪些类型？
IC卡长啥样	IC卡有哪些类型？
一般的IC卡有那些	IC卡有哪些类型？
IC卡是怎么分类的？	IC卡有哪些类型？
我怎么知道更多的银联IC卡资料？	我怎么知道更多的银联IC卡资料？
银行卡怎么支持闪付	我怎么知道更多的银联IC卡资料？
你好信用卡的QUICKPASS闪付功能使用时银行端的小额免密功能必须要开通吗？	我怎么知道更多的银联IC卡资料？
银联在网上有对银联IC卡的宣传吗？	我怎么知道更多的银联IC卡资料？
IC卡有更多的资料介绍吗	我怎么知道更多的银联IC卡资料？
IC卡资料有哪些	我怎么知道更多的银联IC卡资料？
IC卡资料	我怎么知道更多的银联IC卡资料？
我想咨询一下闪付，是怎么回事啊	我怎么知道更多的银联IC卡资料？
闪付是怎么使用的啊	我怎么知道更多的银联IC卡资料？
如何获得更多IC卡业务？	我怎么知道更多的银联IC卡资料？
如何获得更多芯片卡业务？	我怎么知道更多的银联IC卡资料？
电子现金圈存有手续费吗？	电子现金圈存有手续费吗？
圈存收费吗？	电子现金圈存有手续费吗？
圈存电子现金有没有额外的费用	电子现金圈存有手续费吗？
圈存有费用的要求吗	电子现金圈存有手续费吗？
电子现金圈存有什么要求	电子现金圈存有手续费吗？
圈存要手续费吗？	电子现金圈存有手续费吗？
圈存要收多少费用？	电子现金圈存有手续费吗？
圈存要付额外费用吗	电子现金圈存有手续费吗？
电子现金圈存要付费吗？	电子现金圈存有手续费吗？
在哪些地点可以圈存电子现金？	在哪些地点可以圈存电子现金？
在哪儿做圈存	在哪些地点可以圈存电子现金？
什么银行支持圈存	在哪些地点可以圈存电子现金？
跨行可以圈存吗	在哪些地点可以圈存电子现金？
取款机可以圈存吗	在哪些地点可以圈存电子现金？
电话可以圈存吗	在哪些地点可以圈存电子现金？
IC卡的电子现金圈存目前支持哪些银行？	在哪些地点可以圈存电子现金？
建行支持电子现金圈存吗？	在哪些地点可以圈存电子现金？
我的银行卡支持电子现金圈存吗？	在哪些地点可以圈存电子现金？
哪些银行可以圈存？	在哪些地点可以圈存电子现金？
圈存的网点在哪里？	在哪些地点可以圈存电子现金？
怎么将钱存到电子现金？	在哪些地点可以圈存电子现金？
怎样才知道哪些商家可以使用银联IC卡闪付交易？	怎样才知道哪些商家可以使用银联IC卡闪付交易？
某地区哪里有支持闪付的地方	怎样才知道哪些商家可以使用银联IC卡闪付交易？
某地区（例如广东中山南头等）哪里有大型的闪付功能的超市	怎样才知道哪些商家可以使用银联IC卡闪付交易？
中山哪里有大型的闪付功能的超市	怎样才知道哪些商家可以使用银联IC卡闪付交易？
广东哪里有大型的闪付功能的超市	怎样才知道哪些商家可以使用银联IC卡闪付交易？
西安哪里有大型的闪付功能的商场	怎样才知道哪些商家可以使用银联IC卡闪付交易？
某地区支持闪付的商场（有哪些）	怎样才知道哪些商家可以使用银联IC卡闪付交易？
银联IC卡在哪儿用	怎样才知道哪些商家可以使用银联IC卡闪付交易？
闪付支持的商户有那些	怎样才知道哪些商家可以使用银联IC卡闪付交易？
闪付有什么优惠活动	怎样才知道哪些商家可以使用银联IC卡闪付交易？
沃尔玛超市的工商银行带有闪付POS机为什么不能刷闪付和云闪付？	怎样才知道哪些商家可以使用银联IC卡闪付交易？
银联IC卡怎么用	怎样才知道哪些商家可以使用银联IC卡闪付交易？
家乐福支持闪付交易吗？	怎样才知道哪些商家可以使用银联IC卡闪付交易？
IC卡闪付交易可到哪些商户去使用？	怎样才知道哪些商家可以使用银联IC卡闪付交易？
有闪付支持商家名单吗？	怎样才知道哪些商家可以使用银联IC卡闪付交易？
哪些商户可以支付闪付交易？	怎样才知道哪些商家可以使用银联IC卡闪付交易？
电子现金账户里面钱，到哪些商户可以使用？	电子现金账户里面钱，到哪些商户可以使用？
请问一沃尔玛超市可以使用脱机闪付也就是电子现金吗	电子现金账户里面钱，到哪些商户可以使用？
请问沃尔玛支持脱机闪付吗	电子现金账户里面钱，到哪些商户可以使用？
你好，我给邮储信用卡还款，错存成电子现金了！山西太原美特好超市也去试了，不能用电子现金！	电子现金账户里面钱，到哪些商户可以使用？
想再咨询一下，山西太原可以支持电子现金的商家有哪些	电子现金账户里面钱，到哪些商户可以使用？
圈存后的钱怎么用	电子现金账户里面钱，到哪些商户可以使用？
电子现金可以用在公交车吗	电子现金账户里面钱，到哪些商户可以使用？
某地区可以支持电子现金的商家有哪些	电子现金账户里面钱，到哪些商户可以使用？
请问某超市可以使用脱机闪付也就是电子现金吗	电子现金账户里面钱，到哪些商户可以使用？
电子现金账户可以在那些便利店使用	电子现金账户里面钱，到哪些商户可以使用？
电子现金账户可以当交通卡用吗？	电子现金账户里面钱，到哪些商户可以使用？
电子现金账户可以在自助售货机使用吗？	电子现金账户里面钱，到哪些商户可以使用？
哪些商户支持闪付脱机交易？	电子现金账户里面钱，到哪些商户可以使用？
闪付脱机支持哪些商户？	电子现金账户里面钱，到哪些商户可以使用？
IC卡的电子现金交易具体有哪些商户支持？	电子现金账户里面钱，到哪些商户可以使用？
哪些商户可以使用电子现金消费	电子现金账户里面钱，到哪些商户可以使用？
我把钱误存到电子现金账户啦，该怎么用	电子现金账户里面钱，到哪些商户可以使用？
什么是小额免密免签？	什么是小额免密免签？
为什么我在商户刷卡时没有输入密码就支付成功了啊	什么是小额免密免签？
我想咨询一下小额免密？	什么是小额免密免签？
我想问下默认开通免密免签的银行有哪些	什么是小额免密免签？
哪些卡片支持小额免密免签	什么是小额免密免签？
支持小额免密免签的银行有哪些	什么是小额免密免签？
小额免密免签商户有哪些？	什么是小额免密免签？
小额免密免签商户	什么是小额免密免签？
小额免密支付	什么是小额免密免签？
使用小额免密有什么要求吗？	什么是小额免密免签？
怎么使用小额免密业务？	什么是小额免密免签？
如何使用小额免密业务？	什么是小额免密免签？
小额免密免签有什么好处	什么是小额免密免签？
小额免密免签怎么开通	什么是小额免密免签？
咨询个问题最近POS刷卡消费，不用输入密码，也不要签字了	什么是小额免密免签？
能不能大致介绍一下小额免密免签业务？	什么是小额免密免签？
我想了解小额免密免签业务	什么是小额免密免签？
哪些商户可以使用小额免密免签？	什么是小额免密免签？
小额免密免签的单笔交易限额可以修改吗？	小额免密免签的单笔交易限额可以修改吗？
闪付免密额度可以调整吗	小额免密免签的单笔交易限额可以修改吗？
小额免密免签的额度（是多少？）	小额免密免签的单笔交易限额可以修改吗？
小额免密(单笔)限额可以自行设置吗？	小额免密免签的单笔交易限额可以修改吗？
小额免密的金额是多少	小额免密免签的单笔交易限额可以修改吗？
多少钱可以免密	小额免密免签的单笔交易限额可以修改吗？
小额免密有金额限制吗？	小额免密免签的单笔交易限额可以修改吗？
小额免密有没有金额限制？	小额免密免签的单笔交易限额可以修改吗？
帮我查下我办卡时预留的电话	帮我查下我办卡时预留的电话
我银行卡预留的电话是什么	帮我查下我办卡时预留的电话
请问银联信用卡的银行预留号码怎么查	帮我查下我办卡时预留的电话
不去某银行可不可以修改预留电话号码	帮我查下我办卡时预留的电话
如何知道云南农村信用社卡是否正常使用	帮我查下我办卡时预留的电话
如何知道工商银行卡是否正常使用	帮我查下我办卡时预留的电话
我想改银行卡绑定的电话号	帮我查下我办卡时预留的电话
我用A银行的卡片在B银行的ATM机具上取款，要收取多少手续费？	我用A银行的卡片在B银行的ATM机具上取款，要收取多少手续费？
ATM取款手续费	我用A银行的卡片在B银行的ATM机具上取款，要收取多少手续费？
银联商务助农金融自助终端的取款手续费？	我用A银行的卡片在B银行的ATM机具上取款，要收取多少手续费？
助农取款手续费怎么收	我用A银行的卡片在B银行的ATM机具上取款，要收取多少手续费？
助农取款手续费收多少？	我用A银行的卡片在B银行的ATM机具上取款，要收取多少手续费？
跨行取款手续费怎么算	我用A银行的卡片在B银行的ATM机具上取款，要收取多少手续费？
招行卡跨行取款有手续费吗	我用A银行的卡片在B银行的ATM机具上取款，要收取多少手续费？
取钱要收手续费吗	我用A银行的卡片在B银行的ATM机具上取款，要收取多少手续费？
A银行卡在B银行取款要收多少手续费	我用A银行的卡片在B银行的ATM机具上取款，要收取多少手续费？
A银行卡在B银行取款有手续费吗	我用A银行的卡片在B银行的ATM机具上取款，要收取多少手续费？
ATM取款手续费怎么收	我用A银行的卡片在B银行的ATM机具上取款，要收取多少手续费？
什么银行跨行取款不收费	我用A银行的卡片在B银行的ATM机具上取款，要收取多少手续费？
各家银行跨行取款的费用是多少	我用A银行的卡片在B银行的ATM机具上取款，要收取多少手续费？
ATM跨行取款手续费	我用A银行的卡片在B银行的ATM机具上取款，要收取多少手续费？
我的银行会收取我ATM跨行取款手续费吗？	我用A银行的卡片在B银行的ATM机具上取款，要收取多少手续费？
为什么收了这么多的ATM取款手续费？	我用A银行的卡片在B银行的ATM机具上取款，要收取多少手续费？
跨行取款的手续费是谁收取的？	我用A银行的卡片在B银行的ATM机具上取款，要收取多少手续费？
跨行取款是否需要手续费？	我用A银行的卡片在B银行的ATM机具上取款，要收取多少手续费？
我用A银行的卡片在B银行的ATM机具上查询余额，要收取多少手续费？	我用A银行的卡片在B银行的ATM机具上查询余额，要收取多少手续费？
通过取款机查余额收费吗	我用A银行的卡片在B银行的ATM机具上查询余额，要收取多少手续费？
通过取款机查余额怎么收费	我用A银行的卡片在B银行的ATM机具上查询余额，要收取多少手续费？
查询余额要收手续费吗	我用A银行的卡片在B银行的ATM机具上查询余额，要收取多少手续费？
通过取款机查余额的收费标准是什么	我用A银行的卡片在B银行的ATM机具上查询余额，要收取多少手续费？
通过取款机查余额是免费的吗	我用A银行的卡片在B银行的ATM机具上查询余额，要收取多少手续费？
通过取款机查余额被多收费了，怎么办	我用A银行的卡片在B银行的ATM机具上查询余额，要收取多少手续费？
ATM跨行查询手续费	我用A银行的卡片在B银行的ATM机具上查询余额，要收取多少手续费？
银行会收取我ATM跨行查询手续费吗？	我用A银行的卡片在B银行的ATM机具上查询余额，要收取多少手续费？
跨行ATM查询余额的手续费是谁收取的？	我用A银行的卡片在B银行的ATM机具上查询余额，要收取多少手续费？
我在跨行ATM机上查询余额，会被扣手续费吗？	我用A银行的卡片在B银行的ATM机具上查询余额，要收取多少手续费？
我在取款机上查询余额，要扣多少手续费？	我用A银行的卡片在B银行的ATM机具上查询余额，要收取多少手续费？
工行的卡在农行的机具上查还有多少钱，要收手续费吗？	我用A银行的卡片在B银行的ATM机具上查询余额，要收取多少手续费？
工行的卡在农行的机具上查余额，要收手续费吗？	我用A银行的卡片在B银行的ATM机具上查询余额，要收取多少手续费？
我的交易消费撤销了，为什么没有收到钱？	我的交易消费撤销了，为什么没有收到钱？
消费撤销后，钱多久到帐	我的交易消费撤销了，为什么没有收到钱？
消费撤销后，钱没到帐怎么办	我的交易消费撤销了，为什么没有收到钱？
交易取消了，为什么钱没回来	我的交易消费撤销了，为什么没有收到钱？
消费撤销没打单，能收到钱吗？	我的交易消费撤销了，为什么没有收到钱？
机器做不了消费撤销，怎么办？	我的交易消费撤销了，为什么没有收到钱？
我消费撤销已经好长时间了，一直没返回卡里	我的交易消费撤销了，为什么没有收到钱？
消费撤销的钱没退到银行卡内，如何处理	我的交易消费撤销了，为什么没有收到钱？
撤销钱没到账	我的交易消费撤销了，为什么没有收到钱？
消费撤销钱何时到账？	我的交易消费撤销了，为什么没有收到钱？
消费撤销，何时入账	我的交易消费撤销了，为什么没有收到钱？
商户当天就帮我取消交易了，银行卡为什么还没有到账？	我的交易消费撤销了，为什么没有收到钱？
商户当天就帮我取消交易了，信用卡额度为什么还没有恢复？	我的交易消费撤销了，为什么没有收到钱？
我消费撤销了，为什么没有收到钱	我的交易消费撤销了，为什么没有收到钱？
我需要查询自己的征信情况	我需要查询自己的征信情况
我想查办了多少信用卡	我需要查询自己的征信情况
你好，请问这边可以查询身份证下所有的办卡记录么？	我需要查询自己的征信情况
我想知道自己的身份证有没有办理过各种卡	我需要查询自己的征信情况
查询有几张信用卡	我需要查询自己的征信情况
我想查我的身份证贷款情况	我需要查询自己的征信情况
怎么查询是否有不良记录	我需要查询自己的征信情况
征信中心电话多少？	我需要查询自己的征信情况
征信中心电话有吗？	我需要查询自己的征信情况
征信中心网址（网站）是什么？	我需要查询自己的征信情况
征信中心有网站吗？	我需要查询自己的征信情况
如何查询名下是否存在信用卡	我需要查询自己的征信情况
在哪儿查征信	我需要查询自己的征信情况
怎么查征信记录	我需要查询自己的征信情况
查询征信情况需要什么材料	我需要查询自己的征信情况
如何修改征信记录	我需要查询自己的征信情况
征信记录保持多久	我需要查询自己的征信情况
我要查询我的个人身份证所办理的所有信用卡	我需要查询自己的征信情况
我有没有不良信用记录？	我需要查询自己的征信情况
个人征信怎么查询？	我需要查询自己的征信情况
我想查一下我的信用情况。	我需要查询自己的征信情况
我想查一下我的信用报告。	我需要查询自己的征信情况
能帮我查询一下我名下办理了几张信用卡吗？	我需要查询自己的征信情况
我名下办理了几张信用卡	我需要查询自己的征信情况
我在这个商户刷卡消费为什么没有积分？	我在这个商户刷卡消费为什么没有积分？
刷卡消费没有积分是什么原因	我在这个商户刷卡消费为什么没有积分？
刷卡消费如何积分	我在这个商户刷卡消费为什么没有积分？
什么商户刷卡没积分	我在这个商户刷卡消费为什么没有积分？
请问我的银联帐号买了那么多火车票，怎么没有积分呀	我在这个商户刷卡消费为什么没有积分？
我要投诉去永辉刷卡消费没积分！	我在这个商户刷卡消费为什么没有积分？
我要投诉去KTV刷卡消费没积分！	我在这个商户刷卡消费为什么没有积分？
哪些商户刷卡有积分	我在这个商户刷卡消费为什么没有积分？
如何确认交易有积分？	我在这个商户刷卡消费为什么没有积分？
在哪些商户操作会获得积分？	我在这个商户刷卡消费为什么没有积分？
哪些商户消费银行给积分？	我在这个商户刷卡消费为什么没有积分？
可以给我一份刷卡消费银行给积分的名单吗？	我在这个商户刷卡消费为什么没有积分？
为什么银行不给我积分？	我在这个商户刷卡消费为什么没有积分？
家乐福刷卡有积分吗？	我在这个商户刷卡消费为什么没有积分？
刷卡没有获得积分	我在这个商户刷卡消费为什么没有积分？
这笔消费的信用卡积分是多少？	我在这个商户刷卡消费为什么没有积分？
这笔消费的积分是多少？	我在这个商户刷卡消费为什么没有积分？
我想查银行卡消费积分	我在这个商户刷卡消费为什么没有积分？
商户刷卡为什么没有积分	我在这个商户刷卡消费为什么没有积分？
我被加入银联黑名单了，该怎么办？	我被加入银联黑名单了，该怎么办？
什么是银联黑名单	我被加入银联黑名单了，该怎么办？
为什么会进银联黑名单	我被加入银联黑名单了，该怎么办？
进了银联黑名单会怎么样	我被加入银联黑名单了，该怎么办？
如何从银联黑名单中出来	我被加入银联黑名单了，该怎么办？
在哪儿查银联黑名单	我被加入银联黑名单了，该怎么办？
如何清除银联黑名单？	我被加入银联黑名单了，该怎么办？
银行说我进入银联黑名单，如何处理？	我被加入银联黑名单了，该怎么办？
银联黑名单如何取消？	我被加入银联黑名单了，该怎么办？
银联黑名单	我被加入银联黑名单了，该怎么办？
我为什么被银联拉黑了？	我被加入银联黑名单了，该怎么办？
你们银联有黑名单吗？	我被加入银联黑名单了，该怎么办？
中国银联的官方微信号是什么？	中国银联的官方微信号是什么？
上海银联的官方微信号	中国银联的官方微信号是什么？
境外银联的官方微信号是什么	中国银联的官方微信号是什么？
银联国际的微信号	中国银联的官方微信号是什么？
UNIONPAY<数字>这个是银联官方微信号吗？	中国银联的官方微信号是什么？
银联官方微信号是UNIONPAY<数字>吗？	中国银联的官方微信号是什么？
UP_<数字>这个是银联官方微信号吗？	中国银联的官方微信号是什么？
银联的公众号是什么？	中国银联的官方微信号是什么？
我微信上怎么关注你们？	中国银联的官方微信号是什么？
你们有微信公众号吗？	中国银联的官方微信号是什么？
银联的微信是什么	中国银联的官方微信号是什么？
银联有官微吗	中国银联的官方微信号是什么？
银联有官方微信吗	中国银联的官方微信号是什么？
银联有微信号吗	中国银联的官方微信号是什么？
银联的官方微信号是什么	中国银联的官方微信号是什么？
我的银行卡可以借给别人使用吗？	我的银行卡可以借给别人使用吗？
银行卡借给别人是否安全	我的银行卡可以借给别人使用吗？
银行卡如果借给别人，可以否认交易吗	我的银行卡可以借给别人使用吗？
身份证可以借给别人办卡吗？	我的银行卡可以借给别人使用吗？
我老婆能用我的银行卡刷卡消费吗？	我的银行卡可以借给别人使用吗？
我家人能用我的银行卡交易吗？	我的银行卡可以借给别人使用吗？
我朋友能用我的银行卡交易吗？	我的银行卡可以借给别人使用吗？
我的卡借给别人刷	我的银行卡可以借给别人使用吗？
我的卡借给别人用	我的银行卡可以借给别人使用吗？
卡能借给别人用吗	我的银行卡可以借给别人使用吗？
帮我查询一下银行卡余额	帮我查询一下银行卡余额
你好在<数字>网站上面可以查询我的银行卡余额及银行卡交易记录往来账清单吗	帮我查询一下银行卡余额
我想查查卡上多少钱	帮我查询一下银行卡余额
我要咨询我的卡是那个网点	帮我查询一下银行卡余额
我想看看我现在卡里还有多少额度	帮我查询一下银行卡余额
你好，我有几张双币银联卡不知道怎么查询余额	帮我查询一下银行卡余额
（你好）我有几张双币银联卡不知道怎么查询余额	帮我查询一下银行卡余额
你好<DIV>帮我查一下<数字>这个卡里面有多少钱	帮我查询一下银行卡余额
在吗？我有几张双币银联卡，不知道怎么查余额，你能帮我查吗	帮我查询一下银行卡余额
怎么查账户余额	帮我查询一下银行卡余额
在哪儿查银行卡余额	帮我查询一下银行卡余额
查询银行卡余额的方式有那些	帮我查询一下银行卡余额
银行卡里还有多少钱？	帮我查询一下银行卡余额
看下我卡里还有多少钱？	帮我查询一下银行卡余额
我的卡片丢失了，该怎么办？	我的卡片丢失了，该怎么办？
我的银行卡被人偷了，怎么办？	我的卡片丢失了，该怎么办？
家人的银行卡丢了，可以代为挂失吗？	我的卡片丢失了，该怎么办？
银行卡丢了，如何重办	我的卡片丢失了，该怎么办？
我的卡片被偷了，该怎么办？	我的卡片丢失了，该怎么办？
我要挂失银行卡。	我的卡片丢失了，该怎么办？
如何办理挂失手续？	我的卡片丢失了，该怎么办？
挂失流程？	我的卡片丢失了，该怎么办？
我可以把POS机具借给其他商户使用吗？	我可以把POS机具借给其他商户使用吗？
刷卡机可以给别人用吗？	我可以把POS机具借给其他商户使用吗？
刷卡机借给其他商户安全吗	我可以把POS机具借给其他商户使用吗？
别人顶了我的店，我可以把刷卡机直接留给他用吗？	我可以把POS机具借给其他商户使用吗？
刷卡机借给别的商户用，有什么风险	我可以把POS机具借给其他商户使用吗？
刷卡机可以送人吗？	我可以把POS机具借给其他商户使用吗？
我把POS机借给我朋友使用一下，行吗？	我可以把POS机具借给其他商户使用吗？
我可以把POS机具借给家乐福使用吗？	我可以把POS机具借给其他商户使用吗？
POS可以借来用吗？	我可以把POS机具借给其他商户使用吗？
我可以和其他商户共用一个POS机吗？	我可以把POS机具借给其他商户使用吗？
多个商户能共用一个POS吗	我可以把POS机具借给其他商户使用吗？
别的商户能共用POS	我可以把POS机具借给其他商户使用吗？
什么是跨行转账业务？	什么是跨行转账业务？
你好，请问一下我想参加跨行转账的活动的，如果我在民生银行用工行卡转到工行卡算跨行转账吗？谢谢	什么是跨行转账业务？
请问一下我想参加跨行转账的活动，如果我在建设银行用招商银行转到招商银行算跨行转账吗？	什么是跨行转账业务？
你好请问一下我在民生ATM用工行卡转帐到另一工行卡，算跨行转账吗	什么是跨行转账业务？
跨行转账有那哪方式	什么是跨行转账业务？
如何进行跨行转账	什么是跨行转账业务？
跨行转账安全吗	什么是跨行转账业务？
跨行转账只能通过ATM吗？	什么是跨行转账业务？
跨行转账怎么弄	什么是跨行转账业务？
跨行转账怎么做	什么是跨行转账业务？
ATM机能进行跨行转账吗？	ATM机能进行跨行转账吗？
什么银行支持跨行转账	ATM机能进行跨行转账吗？
通过取款机跨行转账有哪些要求	ATM机能进行跨行转账吗？
通过取款机跨行转账需要开通吗	ATM机能进行跨行转账吗？
ATM跨行转账如何操作？	ATM机能进行跨行转账吗？
跨行转账能到ATM操作吗？	ATM机能进行跨行转账吗？
我的卡可以ATM跨行转账吗	ATM机能进行跨行转账吗？
ATM能否用不同银行卡转账。	ATM机能进行跨行转账吗？
我能用ATM机给另外一个银行卡转钱吗？	ATM机能进行跨行转账吗？
跨行转账能在取款机上做吗	ATM机能进行跨行转账吗？
能用信用卡进行转账吗？	能用信用卡进行转账吗？
信用卡支持转账吗	能用信用卡进行转账吗？
信用卡如何转账	能用信用卡进行转账吗？
信用卡转账要开通吗	能用信用卡进行转账吗？
信用卡转账有手续费吗	能用信用卡进行转账吗？
为什么我信用卡上的钱转不到其他银行卡上？	能用信用卡进行转账吗？
什么是跨行存款？	什么是跨行存款？
可通过银行CDM（存款机）进行跨行存款吗？	什么是跨行存款？
可以跨行存款吗？	什么是跨行存款？
建行卡可通过银行CDM（存款机）进行跨行存款吗？	什么是跨行存款？
CRS跨行存款是什么？	什么是跨行存款？
跨行存款怎么弄	什么是跨行存款？
跨行存款怎么做	什么是跨行存款？
某银行有开通柜面通业务吗？	某银行有开通柜面通业务吗？
什么银行支持柜面通	某银行有开通柜面通业务吗？
如何开通柜面通吗	某银行有开通柜面通业务吗？
柜面通交易收费吗	某银行有开通柜面通业务吗？
柜面通安全吗	某银行有开通柜面通业务吗？
我的银行卡有开通柜面通业务吗？	某银行有开通柜面通业务吗？
哪些银行卡支持柜面通过业务？	某银行有开通柜面通业务吗？
工商银行有开通柜面通业务吗？	某银行有开通柜面通业务吗？
哪些银行有柜面通？	某银行有开通柜面通业务吗？
我能不能在柜面跨行存款？	某银行有开通柜面通业务吗？
我能在农行柜台存款吗	某银行有开通柜面通业务吗？
我是工行的银行卡，能在农行柜台存款吗？	某银行有开通柜面通业务吗？
取款机坏了，该怎么办？	取款机坏了，该怎么办？
取款机被堵住了，怎么办	取款机坏了，该怎么办？
取款机没电了怎么办	取款机坏了，该怎么办？
取款机死机了怎么办	取款机坏了，该怎么办？
取款机没钱了，怎么办	取款机坏了，该怎么办？
取款机不吐钞怎么办	取款机坏了，该怎么办？
维修ATM机器，该找哪里？	取款机坏了，该怎么办？
这个ATM机为什么不能取钱了？	取款机坏了，该怎么办？
我要调看ATM录像。	我要调看ATM录像。
如何调看取款录像	我要调看ATM录像。
在哪儿调看取款录像	我要调看ATM录像。
调看取款录像需要什么凭证	我要调看ATM录像。
最远能调看多长时间的录像	我要调看ATM录像。
调看取款录像需要什么审批手续	我要调看ATM录像。
我要调看ATM的摄像。	我要调看ATM录像。
我想知道这笔钱是谁取的？	我要调看ATM录像。
我没有印象在这个地方取过钱，为什么钱却被扣了？	我要调看ATM录像。
请问企业合作是怎么合作？	如何和银联合作
我想问下如果要开一个网站，然后要做银联对接，需要做什么	如何和银联合作
请问银联可以给商户开通代收代付功能吗？	如何和银联合作
想申请商家账户。连接到网站上。让顾客可以用网银支付。	如何和银联合作
我们公司想注册商户进行收款	如何和银联合作
我们做了一个APP，需要集成银联支付，想问下个人买家付款的资金流向是什么样的	如何和银联合作
我怎么获得支付接口	如何和银联合作
你好，想问下，我们公司要在银联注册成商户，然后在我们平台做快捷支付	如何和银联合作
如何成为银联在线支付代理?费率是多少？	如何和银联合作
目前，我们官网可以直接开通银联在线支付嘛？	如何和银联合作
你好，请问下，怎么接入你们的支付接口呢	如何和银联合作
开通支付接口	如何和银联合作
商户开通银联支付	如何和银联合作
请问申请成为在线商户怎么申请	如何和银联合作
我们公司网站想添加银联的支付功能，需要怎么办理	如何和银联合作
我有个购物网站，要申请在线支付，要怎么操作？	如何和银联合作
网站要开通银联收费，想了解收费标准是什么	如何和银联合作
请问我如果想搭建一个自主支付平台使用银联支付需要怎么做	如何和银联合作
请问如果我有自己的APP要接入银行卡支付，请问有文档吗？	如何和银联合作
银联开放平台在哪	如何和银联合作
我公司想用银联支付	如何和银联合作
我的网站需要申请开通一个在线银联卡收款	如何和银联合作
请问我需要申请银联支付集成到手机上是在这申请么	如何和银联合作
企业想开通网站的网上支付	如何和银联合作
如何成为银联网上商户	如何和银联合作
如何成为网上商户	如何和银联合作
如何加入网上银联	如何和银联合作
加入银联在线支付需要什么手续	如何和银联合作
成为银联在线支付商户需要多多长时间	如何和银联合作
网站怎么加入银联？	如何和银联合作
商户怎么加入银联？	如何和银联合作
申请加入银联在线支付	如何和银联合作
我有个在线商城，想接入银联支付接口，怎么办？	如何和银联合作
我有个网站，想让客户用银联支付来付款，怎么办？	如何和银联合作
我的网站想开通银联支付接口，怎么办？	如何和银联合作
如果我们自己的商城想对接银联支付接口，应该找谁？	如何和银联合作
我们网站想开通银联在线支付功能，需要怎么处理？	如何和银联合作
银联支付接口	如何和银联合作
我们新建了在线商城，想用银联在线	如何和银联合作
我是商户，想与银联在线支付合作	如何和银联合作
如何接入银联在线支付？	如何和银联合作
如何在网站添加在线支付接口？	如何和银联合作
我怎么加入你们银联的网上平台？	如何和银联合作
我怎么加入你们银联的网上支付平台？	如何和银联合作
商户怎么加入你们银联的网上平台？	如何和银联合作
我怎么接入你们银联的网上平台？	如何和银联合作
我怎么加入你们银联的网上平台接口？	如何和银联合作
你们银联有网上支付的接口吗？	如何和银联合作
商户自助提交入网申请后，为何迟迟未收到收单机构主动联系？	商户自助提交入网申请后，为何迟迟未收到收单机构主动联系？
我申请了一个代付的业务，大概审核要多久呢？	商户自助提交入网申请后，为何迟迟未收到收单机构主动联系？
我们已提交商户入网申请，还要等多久？	商户自助提交入网申请后，为何迟迟未收到收单机构主动联系？
提交商户入网申请后，银行多久会联系我们	商户自助提交入网申请后，为何迟迟未收到收单机构主动联系？
从提交商户入网申请，到最后办理下来，需要多久	商户自助提交入网申请后，为何迟迟未收到收单机构主动联系？
上月已提交商户入网申请，一直没有人联系，怎么办	商户自助提交入网申请后，为何迟迟未收到收单机构主动联系？
提交商户入网申请后，一直无人联系，如何催办	商户自助提交入网申请后，为何迟迟未收到收单机构主动联系？
我申请商户接入了，怎么还没人联系我？	商户自助提交入网申请后，为何迟迟未收到收单机构主动联系？
我在你们网站申请商户接入了，什么时候会联系我？	商户自助提交入网申请后，为何迟迟未收到收单机构主动联系？
我申请了网站接口，一个多月了没人联系我，什么情况？	商户自助提交入网申请后，为何迟迟未收到收单机构主动联系？
我在你们的商家服务申请的银联接口，还没有人联系我。	商户自助提交入网申请后，为何迟迟未收到收单机构主动联系？
我申请商户接入后，多久会联系我？	商户自助提交入网申请后，为何迟迟未收到收单机构主动联系？
申请入网后，一直无人联系，我想查询进度。	商户自助提交入网申请后，为何迟迟未收到收单机构主动联系？
提交入网申请后为什么还没和我联系？	商户自助提交入网申请后，为何迟迟未收到收单机构主动联系？
提交入网申请后一般多久联系？	商户自助提交入网申请后，为何迟迟未收到收单机构主动联系？
我上个月申请了加入银联在线支付，为什么到现在还没人联系？	商户自助提交入网申请后，为何迟迟未收到收单机构主动联系？
申请加入银联在线支付平台了，大概多长时间会跟我联系？	商户自助提交入网申请后，为何迟迟未收到收单机构主动联系？
我最近通过<数字>退款了，什么时候才能到账啊	我最近通过<数字>退款了，什么时候才能到账啊
<数字>退款要多久	我最近通过<数字>退款了，什么时候才能到账啊
<数字>退款快吗？	我最近通过<数字>退款了，什么时候才能到账啊
<数字>退票	我最近通过<数字>退款了，什么时候才能到账啊
<数字>退款	我最近通过<数字>退款了，什么时候才能到账啊
我在<数字>买票了，后来退了，何时到账？	我最近通过<数字>退款了，什么时候才能到账啊
铁道部退款何时到账。	我最近通过<数字>退款了，什么时候才能到账啊
火车票退款，何时入账。	我最近通过<数字>退款了，什么时候才能到账啊
我在<数字>退款了，至今未到账	我最近通过<数字>退款了，什么时候才能到账啊
退票的时间是什么？	我最近通过<数字>退款了，什么时候才能到账啊
为什么退票还没有到账？	我最近通过<数字>退款了，什么时候才能到账啊
<数字>退款，怎么还没到账	我最近通过<数字>退款了，什么时候才能到账啊
<数字>退款，什么时候到账	我最近通过<数字>退款了，什么时候才能到账啊
我在铁道部官网买票，后来退款了，怎么还没到帐？	我最近通过<数字>退款了，什么时候才能到账啊
我在<数字>买票，后来退款了，怎么还没到帐？	我最近通过<数字>退款了，什么时候才能到账啊
我在铁道部官网买票，后来退票了，怎么还没到帐？	我最近通过<数字>退款了，什么时候才能到账啊
我在铁道部官网退款了，怎么还没到帐？	我最近通过<数字>退款了，什么时候才能到账啊
<数字>的退款，大概什么时间到帐？	我最近通过<数字>退款了，什么时候才能到账啊
<数字>的退款，大概什么时间返还？	我最近通过<数字>退款了，什么时候才能到账啊
退票的钱什么时候到账	我最近通过<数字>退款了，什么时候才能到账啊
什么是安全控件？	什么是安全控件？
可以不用安装控件吗	什么是安全控件？
不安控件行吗	什么是安全控件？
必须安装控件吗	什么是安全控件？
什么是安全插件？	什么是安全控件？
一定要安装控件么	什么是安全控件？
为什么要下载安全控件	什么是安全控件？
为什么要下载安全插件	什么是安全控件？
为什么要安装控件？	什么是安全控件？
安全控件是什么？	什么是安全控件？
支付时，要下载一个软件，那是什么？	什么是安全控件？
在输密码那里，要安装一个控件，那是什么？	什么是安全控件？
什么是控件？	什么是安全控件？
控件是什么？	什么是安全控件？
如何安装银联在线支付控件	如何安装银联在线支付控件
密码不能写	如何安装银联在线支付控件
银行卡密码安装不了怎么办	如何安装银联在线支付控件
你好！我在国税网站开票付税无法录入信用卡背面的三位数，请问怎么处理	如何安装银联在线支付控件
开通在线支付若输入不了取款密码怎么办	如何安装银联在线支付控件
银联认证输出不了密码怎么回事	如何安装银联在线支付控件
我怎么才能输入上密码	如何安装银联在线支付控件
信用卡背面的<数字>位数输不上去啊	如何安装银联在线支付控件
我在付款，提示要安装安全控件，谷歌浏览器浏览器，怎么安装，谢谢	如何安装银联在线支付控件
信用卡后面<数字>位数怎么按不上去啊	如何安装银联在线支付控件
无法输入银行卡密码	如何安装银联在线支付控件
为什么注册时创建登录密码一直是请点此安装	如何安装银联在线支付控件
输密码时候一直提示安装控件	如何安装银联在线支付控件
如何安装控件？	如何安装银联在线支付控件
控件要怎么安装？	如何安装银联在线支付控件
为什么密码输不上？	如何安装银联在线支付控件
输密码那里，要装什么吗？	如何安装银联在线支付控件
银行卡密码输不了	如何安装银联在线支付控件
在线支付无法输入银行密码	如何安装银联在线支付控件
银联在线支付控件安装不上怎么办	银联在线支付控件安装不上怎么办
安装了控件以后死机了	银联在线支付控件安装不上怎么办
安装好以后电脑蓝屏	银联在线支付控件安装不上怎么办
密码控件安装超时	银联在线支付控件安装不上怎么办
控件装了也没有用	银联在线支付控件安装不上怎么办
控件咋安不上啊	银联在线支付控件安装不上怎么办
我已经安装控件，还提示我安装控件	银联在线支付控件安装不上怎么办
我已安装控件，为什么还要提示安装控件	银联在线支付控件安装不上怎么办
为什么下载安全控件没用	银联在线支付控件安装不上怎么办
控件有问题	银联在线支付控件安装不上怎么办
下载安装了控件，付款时依旧显示请下载	银联在线支付控件安装不上怎么办
控件下载了没用是怎么回事？	银联在线支付控件安装不上怎么办
下载的安全控件找不到了，怎么办	银联在线支付控件安装不上怎么办
为什么我已经装了控件，还是提示点击安装？	银联在线支付控件安装不上怎么办
我已经安装控件了，为什么还是输不了密码？	银联在线支付控件安装不上怎么办
点击安装控件，怎么没有反应？	银联在线支付控件安装不上怎么办
安装控件显示完成了，刷新后还是不行	银联在线支付控件安装不上怎么办
银联在线支付控件总是失败，什么原因？	银联在线支付控件安装不上怎么办
控件安装不成功怎么？	银联在线支付控件安装不上怎么办
我已经安装了控件，为什么系统总是提示没有安装？	银联在线支付控件安装不上怎么办
安装不了控件怎么办？	银联在线支付控件安装不上怎么办
控件安装不能用	银联在线支付控件安装不上怎么办
为什么已经安装了安全控件，仍显示“安装控件”？	银联在线支付控件安装不上怎么办
安装安全控件后，加载项无此控件	银联在线支付控件安装不上怎么办
密码框里面为什么总是有要求安装安全控件提示我已经安装了呀	银联在线支付控件安装不上怎么办
银联在线支付安全控件下载地址	银联在线支付安全控件下载地址
输入不了卡号后三位	银联在线支付安全控件下载地址
中石化网上加油卡充值，信用卡信息卡有效期输不上	银联在线支付安全控件下载地址
有没有MAC火狐浏览器安全控件安装地址，给发一个	银联在线支付安全控件下载地址
输入卡片末三位那里没发输入怎么办	银联在线支付安全控件下载地址
银联安全控件怎么下载	银联在线支付安全控件下载地址
你好IE版的安全控件下载不下来啊	银联在线支付安全控件下载地址
我在付款的时间卡后三位输不起是怎么回事	银联在线支付安全控件下载地址
卡背面末三位数输入格无法输入？是什么原因	银联在线支付安全控件下载地址
安全控件下载不了	银联在线支付安全控件下载地址
控件下载不了	银联在线支付安全控件下载地址
控件不能下载	银联在线支付安全控件下载地址
控件怎么弄？	银联在线支付安全控件下载地址
输入不了信用卡背后的末三位	银联在线支付安全控件下载地址
有下载控件的地址吗？	银联在线支付安全控件下载地址
控件在哪里下载？	银联在线支付安全控件下载地址
银行卡密码区不能输入	银联在线支付安全控件下载地址
使用银联账户验证服务，MAC系统，CHROME浏览器，输入完信息之后点击提交验证没反应	银联在线支付安全控件下载地址
为什么在线支付报错<数字>	为什么在线支付报错<数字>
报错<数字>	为什么在线支付报错“验签失败<数字>”
交易出错，提示<数字>	为什么在线支付报错<数字>
交易返回<数字>	为什么在线支付报错<数字>
支付后显示<数字>	为什么在线支付报错<数字>
交易失败，代码<数字>	为什么在线支付报错<数字>
<数字>是什么意思？	为什么在线支付报错<数字>
为什么报错<数字>？	为什么在线支付报错<数字>
银行卡被锁报错<数字>怎么办？	为什么在线支付报错<数字>
<数字>	<数字>
系统显示银行卡密码错误次数超限。	为什么在线支付报错<数字>
银联在线支付密码错误次数超限怎么办？	为什么在线支付报错<数字>
我的银行卡密码错误次数超限了，咋办？	为什么在线支付报错<数字>
更改密码的时候，提示密码错误次数超限，怎么回事？	为什么在线支付报错<数字>
很抱歉，您的订单未支付成功！失败原因：密码输入次数超限（<数字>）如何解决	为什么在线支付报错<数字>
报错<数字>怎么处理？	为什么在线支付报错<数字>
页面说交易失败，余额不足	为什么在线支付报错<数字>
银行卡有钱，怎么老是显示余额不足呢？	为什么在线支付报错<数字>
失败原因：卡上的余额不足（<数字>）	为什么在线支付报错<数字>
我做信用卡分期的时候卡里有额度，为什么老提示卡里余额不足？	为什么在线支付报错<数字>
我用电子现金交易的时候，提示我支付失败，余额不足	为什么在线支付报错<数字>
为什么在线支付报错<数字>P<数字>	为什么在线支付报错<数字>P<数字>
交易出错，提示<数字>P<数字>	为什么在线支付报错<数字>P<数字>
交易返回<数字>P<数字>	为什么在线支付报错<数字>P<数字>
支付后显示<数字>P<数字>	为什么在线支付报错<数字>P<数字>
交易失败，代码<数字>P<数字>	为什么在线支付报错<数字>P<数字>
<数字>P<数字>是什么意思？	为什么在线支付报错<数字>P<数字>
为什么报错<数字>P<数字>？	为什么在线支付报错<数字>P<数字>
报错<数字>P<数字>怎么处理？	为什么在线支付报错<数字>P<数字>
<数字>P<数字>	为什么在线支付报错<数字>P<数字>
报错<数字>P<数字>是什么意思？	为什么在线支付报错<数字>P<数字>
为什么在线支付报错<数字>Z<数字>	为什么在线支付报错<数字>Z<数字>
交易出错，提示<数字>Z<数字>	为什么在线支付报错<数字>Z<数字>
交易返回<数字>Z<数字>	为什么在线支付报错<数字>Z<数字>
支付后显示<数字>Z<数字>	为什么在线支付报错<数字>Z<数字>
交易失败，代码<数字>Z<数字>	为什么在线支付报错<数字>Z<数字>
<数字>Z<数字>是什么意思？	为什么在线支付报错<数字>Z<数字>
为什么报错<数字>Z<数字>？	为什么在线支付报错<数字>Z<数字>
报错<数字>Z<数字>怎么处理？	为什么在线支付报错<数字>Z<数字>
<数字>Z<数字>	为什么在线支付报错<数字>Z<数字>
<数字>Z<数字>是什么原因？	为什么在线支付报错<数字>Z<数字>
验证失败，失败原因：持卡人身份信息或手机号输入不正确，验证失败（<数字>Z<数字>）	为什么在线支付报错<数字>Z<数字>
报错<数字>Z<数字>是什么情况？	为什么在线支付报错<数字>Z<数字>
怎么支付不了呢？报错<数字>Z<数字>	为什么在线支付报错<数字>Z<数字>
在线支付错误<数字>	为什么在线支付报错<数字>
银联风险受限（<数字>）	为什么在线支付报错<数字>
你好，银联风险受限怎么解决？<数字>	为什么在线支付报错<数字>
我支付失败了，显示银联风险受限<数字>	为什么在线支付报错<数字>
在线支付出现：交易失败，详情请咨询<数字>（<数字>），怎么回事儿？	为什么在线支付报错<数字>
银联风险受限	为什么在线支付报错<数字>
为什么在线支付报错“验签失败<数字>”	为什么在线支付报错“验签失败<数字>”
报错验签失败怎么办	为什么在线支付报错“验签失败<数字>”
支付出错，验签失败<数字>	为什么在线支付报错“验签失败<数字>”
验签失败是什么原因？	为什么在线支付报错“验签失败<数字>”
验签失败（<数字>）	为什么在线支付报错“验签失败<数字>”
我想问一下验签失败是什么情况？	为什么在线支付报错“验签失败<数字>”
错误代码<数字>是什么意思？	为什么在线支付报错“验签失败<数字>”
“验签失败<数字>”是什么意思？	为什么在线支付报错“验签失败<数字>”
为什么报错“验签失败<数字>”？	为什么在线支付报错“验签失败<数字>”
为什么在线支付报错“当前页面已过期，请返回商户重新发起订单”	为什么在线支付报错“当前页面已过期，请返回商户重新发起订单”
报错：当前页面已过期，请返回商户重新发起订单	为什么在线支付报错“当前页面已过期，请返回商户重新发起订单”
当前页面已过期，请返回商户重新发起订单	为什么在线支付报错“当前页面已过期，请返回商户重新发起订单”
交易出错，提示：当前页面已过期，请返回商户重新发起订单	为什么在线支付报错“当前页面已过期，请返回商户重新发起订单”
交易返回当前页面已过期，请返回商户重新发起订单	为什么在线支付报错“当前页面已过期，请返回商户重新发起订单”
支付后显示当前页面已过期，请返回商户重新发起订单	为什么在线支付报错“当前页面已过期，请返回商户重新发起订单”
我没法支付，显示当前页面已过期，怎么办？	为什么在线支付报错“当前页面已过期，请返回商户重新发起订单”
为什么让返回商户重新发起订单？	为什么在线支付报错“当前页面已过期，请返回商户重新发起订单”
“当前页面已过期，请返回商户重新发起订单”是什么意思？	为什么在线支付报错“当前页面已过期，请返回商户重新发起订单”
为什么报错“当前页面已过期，请返回商户重新发起订单”？	为什么在线支付报错“当前页面已过期，请返回商户重新发起订单”
一个手机号可以申请几张云闪付卡	一张银行卡可以申请几张设备卡（云闪付卡）？
我可以申请几张云闪付卡？	一张银行卡可以申请几张设备卡（云闪付卡）？
我可以申请几张设备卡？	一张银行卡可以申请几张设备卡（云闪付卡）？
HCE云闪付在商店中支付的限额是多少？	HCE云闪付卡的额度是多少？
HCE云闪付有限额吗	HCE云闪付卡的额度是多少？
HCE云闪付的限额是多少	HCE云闪付卡的额度是多少？
HCE云闪付的限额可以提高吗	HCE云闪付卡的额度是多少？
招行卡HCE云闪付交易限额是多少	HCE云闪付卡的额度是多少？
HCE云闪付线下消费是否有限额？	HCE云闪付卡的额度是多少？
云闪付POS使用限额是多少？	云闪付的卡消费限额是多少？
云闪付有POS限额吗？	云闪付的卡消费限额是多少？
云闪付最多能花多少钱	云闪付的卡消费限额是多少？
用云闪付我每天能花多少钱	云闪付的卡消费限额是多少？
云闪付能设置默认卡吗？	如何设置默认卡？
请问云闪付卡的卡号是什么？	如何查询云闪付卡卡号？
我想查看云闪付号与实际银行卡号	如何查询云闪付卡卡号？
之前卸载了的银行卡还能查云闪付号吗	如何查询云闪付卡卡号？
什么是银联卡？	什么是银联卡？
什么是双标识卡？	什么是双标识卡？
什么是双币种卡？	什么是双币种卡？
什么是借记卡？	什么是借记卡？
什么是信用卡？	什么是信用卡？
什么是准贷记卡？	什么是准贷记卡？
什么是借贷合一卡？	什么是借贷合一卡？
什么是公务卡？	什么是公务卡？
什么是联名卡？联名卡有什么特点？	什么是联名卡？联名卡有什么特点？
什么是账单日？	什么是账单日？
什么是信用卡交易日？	什么是信用卡交易日？
什么是银行记账日？	什么是银行记账日？
什么是还款日？	什么是还款日？
什么是免息还款期？	什么是免息还款期？
什么是最低还款额？	什么是最低还款额？
什么是信用卡积分？	什么是信用卡积分？
信用卡还款方式有哪些？	信用卡还款方式有哪些？
什么是ATM机，ATM机具备哪些基本功能？	什么是ATM机，ATM机具备哪些基本功能？
什么是磁条银行卡？	什么是磁条银行卡？
什么是磁条卡	什么是磁条银行卡？
什么是自助银行？	什么是自助银行？
什么是销售点终端（POS）？	什么是销售点终端（POS）？
POS机除了刷卡，还有什么功能？	什么是销售点终端（POS）？
什么是金融IC卡？	什么是金融IC卡？
什么是收单机构？	什么是收单机构？
什么是柜面通？	什么是柜面通？
什么是联网通用？	什么是联网通用？
什么是银联在线支付	什么是银联在线支付
银联无卡支付业务	什么是银联在线支付
什么是银联认证支付	什么是银联在线支付
什么是银联快捷支付	什么是银联在线支付
什么是银联无卡支付	什么是银联在线支付
无卡支付是什么	什么是银联在线支付
银行卡支行什么意思	什么是银联在线支付
银行卡支付什么意思	什么是银联在线支付
为什么银联在线支付不了	为什么支付不成功
银联在线支付提示不支持该业务	为什么银联在线支付不了
我的卡怎么在线支付不起了	为什么银联在线支付不了
银联在线支付不成功	为什么支付不成功
在线支付怎么不成功呢？	为什么支付不成功
在线支付错误	为什么支付不成功
你好，银联支付错误怎么办？	为什么支付不成功
你好，我现在还款怎么一直是交易失败呢？	为什么支付不成功
为什么我卡里面有钱支付还不了款呀	为什么银联在线支付不了
为什么点击在线支付不能支付？	为什么支付不成功
为什么银联认证支付不了	为什么支付不成功
为什么银联快捷支付不了	为什么支付不成功
为什么银联无卡支付失败	为什么支付不成功
你好，我在线支付为什么说错误呢，我检查好几遍，没有输入错误啊	为什么支付不成功
我的银行卡怎么不能付款？	为什么支付不成功
为什么不能网上支付了	为什么支付不成功
我的招商信用卡绑不了借记卡是什么原因呀	我的银行卡怎么不能付款？
我想咨询一下我的银行卡之前都是正常的使用银联支付为什么这段时间突然提示异常了不能支付了	为什么支付不成功
为什么我的银联卡交不成高考报名费用	我的银行卡怎么不能付款？
为什么我的银行卡无法支付	为什么支付不成功
我有张工行卡怎么不能使用银联在线支付	为什么支付不成功
您的银行卡暂不支持该业务，是什么原因呢？工行的卡。	我的银行卡怎么不能付款？
我有张工行的卡，在银联在线支付，不能支付款項是怎么回事	为什么支付不成功
我在农业银行开通银联卡在进行**支付时，显示失败，是什么原因	我的银行卡怎么不能付款？
发卡行交易权限受限	为什么支付不成功
支付时，说发卡行交易受限	为什么支付不成功
为什么支付不成功	为什么支付不成功
为什么我输入银行卡号后显示我的银行卡不支持该业务，无法充值	为什么支付不成功
为什么老是支付不成功	为什么支付不成功
为什么总是支付失败	为什么支付不成功
付款付不了	为什么支付不成功
为什么我的银行卡无法充值？	为什么支付不成功
已经开通，不能充值	为什么支付不成功
重复支付是什么意思？	为什么支付不成功
提示交易失败	提示交易失败
我的交易失败是怎么会事	提示交易失败
为什么我的银行卡支付的时候提示风险	提示交易失败
你好我扣款时总是交易超时为什么	提示交易失败
我交款显示持卡人身份信息或手机号不对	提示持卡人身份不正确或手机号错误
你好，为什么我输的是银行预留手机号，却说我信息不符呢？	提示持卡人身份不正确或手机号错误
开通银联支付为什么显示手机号不符	提示持卡人身份不正确或手机号错误
为什么我的个人征信绑定银行卡一直提示手机和银行卡预留不一致	银联支付怎么开不了
CVN<数字>错误	提示持卡人身份不正确或手机号错误
提示持卡人身份不正确或手机号错误	失败原因：持卡人身份信息、手机号或CVN<数字>输入不正确，验证失败(<数字>)
怎么老是提示持卡人身份信息或手机号输入不正确，验证失败？	失败原因：持卡人身份信息、手机号或CVN<数字>输入不正确，验证失败(<数字>)
你好.我想了解一下我的卡关联时显示持卡人身份或手机号有误	失败原因：持卡人身份信息、手机号或CVN<数字>输入不正确，验证失败(<数字>)
支付请求超时	支付请求超时
银联系统繁忙，请稍候再试	银联系统繁忙，请稍候再试
显示系统繁忙怎么回事	银联系统繁忙，请稍候再试
银联系统繁忙，请稍后再试	银联系统繁忙，请稍候再试
银联支付怎么开不了	银联支付怎么开不了
绑定银行卡多次显示认证失败，求帮助	银联支付怎么开不了
我开通不了银联在线支付功能怎么办	银联支付怎么开不了
开通在线支付开通不了	银联支付怎么开不了
你好！我查询征信时，在银联认证怎么老是出现信息输入与注册平台不一至	银联支付怎么开不了
银联开通在线支持怎么开通不了？	银联支付怎么开不了
为什么总是显示账户验证失败	银联支付怎么开不了
为什么我银联支付老是身份验证信息有误	银联支付怎么开不了
银联认证怎么开不了	银联支付怎么开不了
银联快捷怎么开不了	银联支付怎么开不了
银联无卡怎么开不了	银联支付怎么开不了
银联支付开通不成功	银联支付怎么开不了
银联认证开通不成功	银联支付怎么开不了
在线支付开通失败	银联支付怎么开不了
建行卡怎么绑定不了	银联支付怎么开不了
你好我的信息都是正确的为什么开通不了	银联支付怎么开不了
订单金额超出该商户限额	订单金额超出该商户限额
报错“订单金额超出该商户限额”是什么意思？	订单金额超出该商户限额
超出该商户限额	订单金额超出该商户限额
BB<数字>什么意思	为什么在线支付报错<数字>
B<数字>	为什么在线支付报错<数字>
我在网上支付不了。给出这样的提示。。发卡行交易权限受限，详情请咨询您的发卡行[<数字>]	为什么在线支付报错<数字>
发卡行交易权限受限，详情请咨询您的发卡行[<数字>]	为什么在线支付报错<数字>
我想查询预授权代码	我想查询预授权代码
麻烦查一个预授权号	我想查询预授权代码
商户可以查询吗？我需要查询预售权码	我想查询预授权代码
预授权码找回	我想查询预授权代码
预授权码查询	我想查询预授权代码
授权码如何查询	我想查询预授权代码
<数字>银联卡有哪些好处啊	<数字>银联卡有哪些好处啊
CVN<数字>是什么意思	CVN<数字>是什么意思
银联卡如何办理	银联卡如何办理
在线支付成功但商家显示未支付	在线支付成功但商家显示未支付
在银联付款成功后，为什么商户页面还是显示未交费呢？	在线支付成功但商家显示未支付
我换了手机号码怎么修改绑定手机号呢	手机号码怎么变更？
修改网上支付功能签约手机	手机号码怎么变更？
你好，我要还款，但是要发验证码到我以前在银行登记的号码，我现在不用那个了，怎么办呢	手机号码怎么变更？
如何修改银联绑定的手机号码	手机号码怎么变更？
在线支付的银行卡手机号码变更	手机号码怎么变更？
如何更改预留手机号码	手机号码怎么变更？
我的手机银行卡预留号码改了可是银联支付还是往旧卡发验证码	手机号码怎么变更？
我在银行柜台改变了手机号但是银联没有变	手机号码怎么变更？
怎么更改银联预留的手机号	手机号码怎么变更？
我银行卡绑定的手机号码明明已经改了，为什么现在付款还是以前的号码？	手机号码怎么变更？
在哪里更改预留的手机号	手机号码怎么变更？
就是我注册时的号码没有用了	手机号码怎么变更？
我的银联卡绑定的手机号原来的，不是现在的，怎么改？	手机号码怎么变更？
你好，我的信用卡到期换卡了，但是卡号不变，不能付款，如何修改之前信息。	你好，我的信用卡到期换卡了，但是卡号不变，不能付款，如何修改之前信息。
在线支付功能开通多久可以使用	在线支付功能开通多久可以使用
银联绑上银行卡后多久能用	在线支付功能开通多久可以使用
银行卡能否在境外使用	银行卡能否在境外使用
我在墨尔本如何取现金	银行卡能否在境外使用
您好,我在台湾可以提款吗	银行卡能否在境外使用
信用卡在德国可以用吗	银行卡能否在境外使用
信用卡在法国可以用吗	银行卡能否在境外使用
信用卡在意大利可以用吗	银行卡能否在境外使用
信用卡在瑞士可以用吗	银行卡能否在境外使用
信用卡在荷兰可以用吗	银行卡能否在境外使用
银联卡能否在捷克使用	银行卡能否在境外使用
马尔代夫可以用**行银联信用卡吗？	银行卡能否在境外使用
请问到北欧能用银联卡吗？	银行卡能否在境外使用
借记卡是否可以境外消费	银行卡能否在境外使用
信用卡在德国、法国、意大利、瑞士、荷兰、可以用吗	银行卡能否在境外使用
在美国能用银联卡吗	银行卡能否在境外使用
我在日本可以用银联卡交易吗	银行卡能否在境外使用
我在拉斯维加斯可以用银联卡交易吗	银行卡能否在境外使用
我是工商银行卡能在韩国ATM取现吗	银行卡能否在境外使用
我是工商银行卡能在韩国刷卡消费吗	银行卡能否在境外使用
澳大利亚可以取钱吗	银行卡能否在境外使用
日本能刷卡吗	银行卡能否在境外使用
你好，我想问一下银联卡在香港能否使用？	银行卡能否在境外使用
美国可以刷银联借记卡吗？	银行卡能否在境外使用
美国可以刷银联信用卡吗？	银行卡能否在境外使用
请问工商银行储蓄卡可以在越南直接提取越南盾吗	银行卡能否在境外使用
我要去境外刷银联卡要开通什么功能	银行卡能否在境外使用
牡丹灵通卡可以在美国使用吗？	银行卡能否在境外使用
请问在英国<数字>开头银联卡哪些银行支持取现？	银行卡能否在境外使用
建行储蓄卡可以境外ATM取款吗？	银行卡能否在境外使用
如何查询汇率	如何查询汇率
人民币新西兰币汇率	如何查询汇率
跨境取款汇率	如何查询汇率
境外刷卡汇率	如何查询汇率
银联一卡通在澳大利亚刷卡汇率多少	如何查询汇率
银联一卡通在美国刷卡汇率多少	如何查询汇率
汇率怎么查	如何查询汇率
在哪里可以查到汇率	如何查询汇率
我要查询<数字>年<数字>月<数字>日的美元汇率	如何查询汇率
人民币兑换韩币汇率怎么查询？	如何查询汇率
在国外用银行卡货币转换汇率怎么算	如何查询汇率
我在网上查了下美元汇率是<数字>.<数字>，你们银联的汇率是多少	如何查询汇率
想问一下，用银联人民币<数字>元兑换日元的时候汇率是多少?	如何查询汇率
境外怎么查询实时消费汇率	如何查询汇率
汇率生效时间	汇率生效时间
汇率几点生效	汇率生效时间
汇率每天几点更新	汇率生效时间
你们汇率是实时更新的吗	汇率生效时间
境外ATM取现是否有次数限制和金额限制？	境外ATM取现是否有次数限制和金额限制？
银联卡境外支取限额	境外ATM取现是否有次数限制和金额限制？
中国银行的借记卡在台湾省使用，有限制额度吗？额度为多少？	境外ATM取现是否有次数限制和金额限制？
国外取现金是如何规定定额的?	境外ATM取现是否有次数限制和金额限制？
我想问下**银行**卡在境外ATM取款的上限	境外ATM取现是否有次数限制和金额限制？
我想问下招商银行储蓄卡在境外ATM取款的上限	境外ATM取现是否有次数限制和金额限制？
我想问下交行信用卡在境外ATM取款的上限	境外ATM取现是否有次数限制和金额限制？
国外取款有限额吗	境外ATM取现是否有次数限制和金额限制？
国外取现的限额是多少	境外ATM取现是否有次数限制和金额限制？
我是农行银行卡在英国每天能取款几次和每天最多能取多少钱	境外ATM取现是否有次数限制和金额限制？
请问银联卡在境外每天取款上限是多少呢？	境外ATM取现是否有次数限制和金额限制？
境外刷卡消费是否有金额限制？	境外刷卡消费是否有金额限制？
国外刷卡有限额吗	境外刷卡消费是否有金额限制？
国外消费的限额是多少	境外刷卡消费是否有金额限制？
我在迪拜刷银联卡每天最多能刷多少钱	境外刷卡消费是否有金额限制？
境外使用银联卡的手续费为多少？	境外使用银联卡的手续费为多少？
我在华夏银行办个储蓄卡，到日本取现如何收费	境外使用银联卡的手续费为多少？
境外取款手续费	境外使用银联卡的手续费为多少？
境外ATM银行对银联卡收取手续费的政策	境外使用银联卡的手续费为多少？
境外提现手续费怎么收	境外使用银联卡的手续费为多少？
境外ATM机取现金有手续费吗	境外使用银联卡的手续费为多少？
美国ATM机取美金手续费是多少	境外使用银联卡的手续费为多少？
境外查询手续费	境外使用银联卡的手续费为多少？
我在**银行办个**卡，到日本取现如何收费	境外使用银联卡的手续费为多少？
我在工商银行办个借记卡，到日本取现如何收费	境外使用银联卡的手续费为多少？
我要到新加坡旅游，用银联卡交易有手续费吗	境外使用银联卡的手续费为多少？
我要到马来西亚旅游，用银联卡消费有手续费吗	境外使用银联卡的手续费为多少？
我要到京都旅游，用银联卡取款有手续费吗	境外使用银联卡的手续费为多少？
国外取款的手续费是多少	境外使用银联卡的手续费为多少？
国外消费有手续费吗	境外使用银联卡的手续费为多少？
境外取款收手续费吗	境外使用银联卡的手续费为多少？
我想问问我农行储蓄卡在香港刷的话是否要收手续费	境外使用银联卡的手续费为多少？
在境外用卡是否需要支付货币转换费	在境外用卡是否需要支付货币转换费
国外交易有货币转换费吗	在境外用卡是否需要支付货币转换费
银联要收货币转换费吗？	在境外用卡是否需要支付货币转换费
境外用卡有哪些优惠活动内容？	境外用卡有哪些优惠活动内容？
美国有哪些优惠活动	境外用卡有哪些优惠活动内容？
东京有什么活动呢	境外用卡有哪些优惠活动内容？
最近我想去丹麦银联有什么活动	境外用卡有哪些优惠活动内容？
银联卡在境外退货是否收取手续费？	银联卡在境外退货是否收取手续费？
我在德国买东西后退货了，有手续费吗	银联卡在境外退货是否收取手续费？
国外商户退货要收手续费，合理吗	银联卡在境外退货是否收取手续费？
我买了化妆品，回国以后要退货	银联卡在境外退货是否收取手续费？
境外国家或城市哪里有银联ATM？	境外国家或城市哪里有银联ATM？
首尔没有银联的ATM机？	境外国家或城市哪里有银联ATM？
美国没有银联的ATM机？	境外国家或城市哪里有银联ATM？
伦敦没有银联的ATM机？	境外国家或城市哪里有银联ATM？
南非没有银联的ATM机？	境外国家或城市哪里有银联ATM？
银联境外取款	境外国家或城市哪里有银联ATM？
东京成田国际机场有银联ATM吗？	境外国家或城市哪里有银联ATM？
伦敦哪里可以取钱	境外国家或城市哪里有银联ATM？
首尔银联ATM地址在哪？	境外国家或城市哪里有银联ATM？
请问在英国可以有银联的ATM机？	境外国家或城市哪里有银联ATM？
美国拉斯维加斯ATM机	境外国家或城市哪里有银联ATM？
银联卡境外交易银行卡背面签名条是否要签名	银联卡境外交易银行卡背面签名条是否要签名
交易的时候商户让我在银行卡背面签名，一定要签吗	银联卡境外交易银行卡背面签名条是否要签名
交易的时候商户一定要我在银行卡背面签名，这样合理吗	银联卡境外交易银行卡背面签名条是否要签名
我在日本买电饭锅，商户一定要我在银行卡背面签名，否则不给刷卡，这样合理吗	银联卡境外交易银行卡背面签名条是否要签名
银联卡境外交易ATM取款时要求输入<数字>位密码怎么办	银联卡境外交易ATM取款时要求输入<数字>位密码怎么办
我在纽约取款的时候只让输<数字>位数的密码，怎么办	银联卡境外交易ATM取款时要求输入<数字>位密码怎么办
我在洛杉矶取款的时候只让输<数字>位数的密码，中国的卡都是<数字>位数密码，怎么办	银联卡境外交易ATM取款时要求输入<数字>位密码怎么办
维卡币是否与银联有合作	维卡币是否与银联有合作
维卡币是和银联卡合作了吗	维卡币是否与银联有合作
中国银联真的发放了印有维卡币标志的银联卡吗？	维卡币是否与银联有合作
维卡币跟你们银联有合作吗？	维卡币是否与银联有合作
维卡币是和银联合作的吗	维卡币是否与银联有合作
请问，维卡币与中国银联合作了吗？	维卡币是否与银联有合作
你好请问银联和维卡币对接了吗	维卡币是否与银联有合作
维卡币对接银联是否属实？	维卡币是否与银联有合作
请问中国银联是否发行过带维卡币标志的银联卡？	维卡币是否与银联有合作
维卡币对接银联是真的吗？	维卡币是否与银联有合作
请问维卡币和你们对接了吗？	维卡币是否与银联有合作
你好请问下维卡币和你银联合作了吗	维卡币是否与银联有合作
请问现在听说银联与虚拟货币维卡币对接了，是吗？	维卡币是否与银联有合作
有维卡币公司宣称与中国银联对接成功，这是真的吗？	维卡币是否与银联有合作
我想咨询下，中国银联和维卡币的关系	维卡币是否与银联有合作
你好~我想请问一下~银联是否有和维卡币合作~开通银联支付呢？	维卡币是否与银联有合作
如何注册银联持卡人服务网站用户名？	如何注册银联持卡人服务网站用户名？
怎么注册银联账户？	如何注册银联持卡人服务网站用户名？
银联账户可以在哪里注册呢？	如何注册银联持卡人服务网站用户名？
我可以在哪里注册银联账户？	如何注册银联持卡人服务网站用户名？
如何寻回安全问题答案？	如何寻回安全问题答案？
忘记安全问题	如何寻回安全问题答案？
我的安全问题答案忘记了如何修改	如何寻回安全问题答案？
密保忘记怎么办	如何寻回安全问题答案？
我忘了安全问题答案怎么办？	如何寻回安全问题答案？
安全问题的答案忘了怎么办？	如何寻回安全问题答案？
我不记得安全问题答案了？	如何寻回安全问题答案？
如何注销注册用户名？	如何注销注册用户名？
有一个账号不想用了	如何注销注册用户名？
你好我要销号银联钱包	如何注销注册用户名？
银联用户注销	如何注销注册用户名？
请问如何注销银联钱包账户？	如何注销注册用户名？
我想注销银联钱包	如何注销注册用户名？
银联钱包怎么注销	如何注销注册用户名？
注销银联钱包	如何注销注册用户名？
如何注销身份认证？手机号给别人了，我的身份想注销	如何注销注册用户名？
能注销账户吗	如何注销注册用户名？
如何注销银联钱包	如何注销注册用户名？
我手机号*******注册的银联钱包忘记密码，也无法找回密码，请注销。谢谢	如何注销注册用户名？
有一个账户***（此为英文或手机号的用户名），还有一个账户***（此为英文或手机号的用户名），两个账户都是我，我想注销一个怎么办	如何注销注册用户名？
手机号打算停机不用了，但之前申请了银联钱包，请问怎么注销账户	如何注销注册用户名？
我的账户没有实名但是我想注销账户	如何注销注册用户名？
你好，我想注销银联钱包如何操作？	如何注销注册用户名？
银联钱包怎么注销呢	如何注销注册用户名？
可以寻回银联账户用户名吗？	可以寻回银联账户用户名吗？
我用户名忘记了，如何能查到？	可以寻回银联账户用户名吗？
我的银联钱包用户名忘了，怎么办	可以寻回银联账户用户名吗？
银联钱包用户名可以寻回吗	可以寻回银联账户用户名吗？
如何寻回登录密码？	如何寻回登录密码？
你好，我登陆密码忘记了	如何寻回登录密码？
我的银联钱包密码忘记了	如何寻回登录密码？
我之前注册过银联的。但是我忘记密保了。也忘记密码	如何寻回登录密码？
我手机停用了没法收到短信怎么找回密码	如何寻回登录密码？
登录密码忘了怎么办？	如何寻回登录密码？
钱包账户密码忘了	如何寻回登录密码？
我要登录银联钱包，一直提示密码错	如何寻回登录密码？
如何修改登录密码？	如何修改登录密码？
银联钱包密码可以修改吗	如何修改登录密码？
为什么设置安全问题？	为什么设置安全问题？
安全问题有什么用	为什么设置安全问题？
安全问题是做什么的？	为什么设置安全问题？
如何设置和修改安全问题？	如何设置和修改安全问题？
我可以在哪里设置安全问题	如何设置和修改安全问题？
安全问题怎么设置？	如何设置和修改安全问题？
怎么修改安全问题？	如何设置和修改安全问题？
安全问题怎么修改？	如何设置和修改安全问题？
安全问题可以变更吗	如何设置和修改安全问题？
一个银联账户可以关联几个身份证？	一个银联账户可以关联几个身份证？
一个身份证可以关联几个银联账户？	一个身份证可以关联几个银联账户？
你好，我的银联钱包账号想实名认证，显示注册账户超限	一个身份证可以关联几个银联账户？
我的身份证可以关联几个银联账户？	一个身份证可以关联几个银联账户？
银联账户已关联身份信息可以修改吗？	银联账户已关联身份信息可以修改吗？
银联钱包怎么解绑身份信息？	银联账户已关联身份信息可以修改吗？
银联钱包，如何更改已经认证过的身份证号？	银联账户已关联身份信息可以修改吗？
我银联卡的实名认证弄错了请问能改吗	银联账户已关联身份信息可以修改吗？
你好咨询下实名认证可以取消吗不用了	银联账户已关联身份信息可以修改吗？
我想把这个手机号对应的身份证信息改成另一个。可能以前验证过。现在怎么改呢	银联账户已关联身份信息可以修改吗？
请问下，我要修改下我账号的身份证认证修改了不了	银联账户已关联身份信息可以修改吗？
请问下，我要修改下我账号的身份证认证	银联账户已关联身份信息可以修改吗？
我可修改银联账户里的个人信息吗	银联账户已关联身份信息可以修改吗？
银联账户支持哪些证件进行实名认证呢？	银联账户支持哪些证件进行实名认证呢？
回乡证支持银联账户的实名认证吗？	银联账户支持哪些证件进行实名认证呢？
学生证支不支持银联账户的实名认证吗？	银联账户支持哪些证件进行实名认证呢？
驾照支持银联账户的实名认证吗？	银联账户支持哪些证件进行实名认证呢？
如何查看银行卡的认证状态？	如何查看银行卡的认证状态？
银行卡的认证状态可以在哪里看到？	如何查看银行卡的认证状态？
我怎么查询我账户里的银行卡的实名情况？	如何查看银行卡的认证状态？
如何进行银行卡实名认证	如何进行银行卡实名认证
我可以在哪里做银行卡的实名认证？	如何进行银行卡实名认证
解绑卡为何需要做实名认证？	解绑卡为何需要做实名认证？
解绑卡需要实名认证吗？	解绑卡为何需要做实名认证？
某机构有没有接入银联，是否安全	某机构有没有接入银联，是否安全
POS机认证查询	某机构有没有接入银联，是否安全
怎么查第三方POS资格	某机构有没有接入银联，是否安全
某某POS机通过银联认证了吗？	某机构有没有接入银联，是否安全
某POS机有牌照吗安全吗	某机构有没有接入银联，是否安全
某机构有没有经过银联认证	某机构有没有接入银联，是否安全
具有全国POS收单的第三方支付公司都是哪些？	某机构有没有接入银联，是否安全
怎么样查询手机POS是否银联认证	某机构有没有接入银联，是否安全
某地某公司有在银联认证吗	某机构有没有接入银联，是否安全
某机构是安全的吗	某机构有没有接入银联，是否安全
某机构是经过你们认证的吗	某机构有没有接入银联，是否安全
某机构是经过银联认证的吗	某机构有没有接入银联，是否安全
支付宝通过银联认证了吗	某机构有没有接入银联，是否安全
财付通是安全的吗	某机构有没有接入银联，是否安全
西安城市一卡通有在银联认证吗	某机构有没有接入银联，是否安全
钱袋宝有你们的认证吗	某机构有没有接入银联，是否安全
闪付联机交易与脱机电子现金有何区别	闪付联机交易与脱机电子现金有何区别
闪付联机和闪付脱机的区别	闪付联机交易与脱机电子现金有何区别
什么是闪付联机	闪付联机交易与脱机电子现金有何区别
电子现金支付	闪付联机交易与脱机电子现金有何区别
什么是闪付脱机	闪付联机交易与脱机电子现金有何区别
什么是闪付脱机交易	闪付联机交易与脱机电子现金有何区别
什么是电子现金支付	闪付联机交易与脱机电子现金有何区别
什么是IC卡闪付？	什么是IC卡闪付？
闪付联机方式消费与平常的刷卡消费有什么区别	什么是IC卡闪付？
什么是IC卡挥卡	什么是IC卡闪付？
什么是闪付	什么是IC卡闪付？
IC卡闪付就是用手机支付？	什么是IC卡闪付？
挥卡交易是什么意思啊。。。。	什么是IC卡闪付？
银联卡闪付功能，是不是只要卡片上带有闪付标志，就可以直接辉卡交易	什么是IC卡闪付？
（您好，）卡片有闪付标识就可以闪付方式支付吗	什么是IC卡闪付？
请问如何查询我的银联IC卡是否支持闪付（挥卡）交易	什么是IC卡闪付？
请问带闪付标志的银联IC卡就可以闪付挥卡交易是吗？	什么是IC卡闪付？
银联IC卡闪付是什么	什么是IC卡闪付？
怎么举报套现？	怎么举报套现？
商户拒刷卡	怎么举报套现？
商户收取我刷卡手续费	怎么举报套现？
我去某场所消费，商家/工作人员/收银员说要收取**手续费	怎么举报套现？
我去买**，商家/工作人员不让我刷卡	怎么举报套现？
POS机套现怎么举报	怎么举报套现？
我去某场所消费，工作人员说要收取<数字>%手续费	怎么举报套现？
我去某场所消费，收银员说要收取<数字>块钱手续费	怎么举报套现？
我去某场所消费，商家说要收取一个点的手续费	怎么举报套现？
我去买东西，工作人员不让我刷卡	怎么举报套现？
跨行转账支持哪些银行卡	跨行转账支持哪些银行卡
我的卡片支持ATM转账吗	跨行转账支持哪些银行卡
建行卡可以跨行转账吗？	跨行转账支持哪些银行卡
怎么知道我的卡支不支持跨行转账	跨行转账支持哪些银行卡
农行卡支持跨行转账吗？	跨行转账支持哪些银行卡
中国人民银行客服热线	中国人民银行客服热线
人民银行电话多少	中国人民银行客服热线
我怎么联系人民银行	中国人民银行客服热线
什么是银联钱包？	什么是银联钱包？
怎么下载并安装银联钱包手机客户端？	怎么下载并安装银联钱包手机客户端？
银联钱包怎么开通	怎么下载并安装银联钱包手机客户端？
银联钱包怎么申请？	怎么下载并安装银联钱包手机客户端？
在哪里下载银联钱包	怎么下载并安装银联钱包手机客户端？
怎么使用银联钱包？	怎么使用银联钱包？
哪些手机可以下载银联钱包？	哪些手机可以下载银联钱包？
银联钱包有公众号吗？	银联钱包有公众号吗？
使用银联钱包客服端手机要上网吗？	使用银联钱包客服端手机要上网吗？
银联钱包怎么实名认证？	银联钱包怎么实名认证？
如何完成银联钱包的实名认证	银联钱包怎么实名认证？
银联钱包实名认证怎么弄	银联钱包怎么实名认证？
如何进行银行卡身份验证	银联钱包怎么实名认证？
什么是完成实名认证	银联钱包怎么实名认证？
请问如何实名认证！	银联钱包怎么实名认证？
银行卡怎么认证	银联钱包怎么实名认证？
银联钱包客户端里的二维码怎么生成？	银联钱包客户端里的二维码怎么生成？
银联钱包的扫码支付支持哪些银行？	银联钱包的扫码支付支持哪些银行？
银联钱包的登录密码与支付密码有什么区别？	银联钱包的登录密码与支付密码有什么区别？
如何使用银联钱包优惠券？	如何使用银联钱包优惠券？
请问银联钱包里抢到优惠券，结帐时一定要与银行卡相联的吗？	如何使用银联钱包优惠券？
银联钱包的优惠券可以退吗？	银联钱包的优惠券可以退吗？
我银联钱包绑定的银行卡删除了，之前下载的优惠券还在吗？	我银联钱包绑定的银行卡删除了，之前下载的优惠券还在吗？
抢完券后关联的银行卡不见了	我银联钱包绑定的银行卡删除了，之前下载的优惠券还在吗？
怎么查询抢到的银联钱包优惠券是到哪张卡的？	怎么查询抢到的银联钱包优惠券是到哪张卡的？
我的银联钱包绑定了几个卡号，然后使用优惠券的时候可以任选一个号用吗	怎么查询抢到的银联钱包优惠券是到哪张卡的？
银联钱包取得优惠券后可随意使用关联的任意张卡吗	怎么查询抢到的银联钱包优惠券是到哪张卡的？
同时绑定了几张银行卡，同时下载了几个优惠券，怎样才能知道哪个优惠券是哪张银行卡的	怎么查询抢到的银联钱包优惠券是到哪张卡的？
我的银联钱包挂了多张卡，怎么知道优惠券挂在哪张卡	怎么查询抢到的银联钱包优惠券是到哪张卡的？
你好，银联钱包绑定了多张符合条件的银行卡，优惠券会在哪一张卡使用呢？	怎么查询抢到的银联钱包优惠券是到哪张卡的？
为什么有些票券无法下载？	为什么有些票券无法下载？
怎样在银联钱包中实名认证，想领优惠券提示我要实名认证	为什么有些票券无法下载？
怎么样实名认证，我抢券，说要认证	为什么有些票券无法下载？
优惠券可以重复使用吗？	优惠券可以重复使用吗？
一个注册用户一张优惠券吗？但是我绑定了多张卡，能分别用吗	优惠券可以重复使用吗？
银联钱包被锁了，还能使用优惠券吗？	银联钱包被锁了，还能使用优惠券吗？
银联钱包支持哪些银行卡绑定？	银联钱包支持哪些银行卡绑定？
银联钱包可以绑定信用卡吗？	银联钱包支持哪些银行卡绑定？
请问银联钱包支持哪些银行卡	银联钱包支持哪些银行卡绑定？
您好，请问银联钱包不能绑定农业银行的银行卡吗？	银联钱包支持哪些银行卡绑定？
银联钱包客户端怎么添加银行卡？	银联钱包客户端怎么添加银行卡？
我登陆上银联以后请问怎么绑定我的农业银行借记卡	银联钱包客户端怎么添加银行卡？
怎么在银联钱包添加银行卡	银联钱包客户端怎么添加银行卡？
如何添加银联钱包卡	银联钱包客户端怎么添加银行卡？
如何关联银行卡	银联钱包客户端怎么添加银行卡？
如何删除银联钱包已绑定的银行卡？	如何删除银联钱包已绑定的银行卡？
怎样解邦银联钱包里的银行卡	如何删除银联钱包已绑定的银行卡？
怎样解绑银联钱包里的银行卡	如何删除银联钱包已绑定的银行卡？
请问我要怎样取消绑定在银联钱包的卡	如何删除银联钱包已绑定的银行卡？
我想取消银联钱包里关联的借记卡，如何操作	如何删除银联钱包已绑定的银行卡？
银联客户端绑定的银行卡如何删除	如何删除银联钱包已绑定的银行卡？
请问如何解除银联钱包被绑定的银行卡	如何删除银联钱包已绑定的银行卡？
请问我在银联钱包里面已绑定的银行卡怎样删除取消	如何删除银联钱包已绑定的银行卡？
我的银联钱包之前绑定的一张信用卡，现在想取消绑定，不能操作	如何删除银联钱包已绑定的银行卡？
我的银联钱包之前绑定的一张借记卡，现在想取消绑定，不能操作	如何删除银联钱包已绑定的银行卡？
银联钱包如何解绑银联卡	如何删除银联钱包已绑定的银行卡？
银联钱包怎么解除捆绑的卡	如何删除银联钱包已绑定的银行卡？
请问银联钱包绑定的银行卡可以解绑吗？	如何删除银联钱包已绑定的银行卡？
如何取消银联钱包关联卡号	如何删除银联钱包已绑定的银行卡？
在银联钱包里怎样删除卡	如何删除银联钱包已绑定的银行卡？
解除绑定银行卡	如何删除银联钱包已绑定的银行卡？
我想解除绑定的银行卡！要怎么操作	如何删除银联钱包已绑定的银行卡？
你好，请问我可不可以取消手机和银行卡的绑定啊	如何删除银联钱包已绑定的银行卡？
银联钱包手机客户端中可以绑定几张银行卡？	银联钱包手机客户端中可以绑定几张银行卡？
请问，一个银联帐户可以同时绑定两张不同银行的卡吗	银联钱包手机客户端中可以绑定几张银行卡？
银联钱包可以帮几张卡	银联钱包手机客户端中可以绑定几张银行卡？
银联钱包可以绑几张卡	银联钱包手机客户端中可以绑定几张银行卡？
一张银行卡能关联几个银联钱包？	一张银行卡能关联几个银联钱包？
你好，请问两个手机号下载的银联钱包可以添加一张银行卡吗？	一张银行卡能关联几个银联钱包？
银联钱包添加银行卡时为什么提示不支持？	银联钱包添加银行卡时为什么提示不支持？
什么是银联红包？	什么是银联红包？
你好！银联钱包里的红包是直接抵现金用吗	什么是银联红包？
怎么获取银联红包	怎么获取银联红包
红包是否有有效期？	红包是否有有效期？
银联红包有使用期限吗	红包是否有有效期？
如何查询我的红包？	如何查询我的红包？
我想查询下银联钱包我的红包怎么查询	如何查询我的红包？
如何查询银联红包余额	如何查询我的红包？
怎么查询银联红包余额	如何查询我的红包？
红包里还剩多少钱在哪里看	如何查询我的红包？
怎么看我还有多少红包	如何查询我的红包？
购物时能全部使用银联红包支付吗？	购物时能全部使用银联红包支付吗？
网上使用红包抵扣失败，钱没扣，红包扣了怎么办？	网上使用红包抵扣失败，钱没扣，红包扣了怎么办？
红包支付退款多久到吖	网上使用红包抵扣失败，钱没扣，红包扣了怎么办？
在线支付失败扣红包能还回账户么	网上使用红包抵扣失败，钱没扣，红包扣了怎么办？
充值失败的红包还没退啊	网上使用红包抵扣失败，钱没扣，红包扣了怎么办？
我的银联红包没有支付成功过了好几天了都还没退给我	网上使用红包抵扣失败，钱没扣，红包扣了怎么办？
银联钱包手机充值多久到账？	银联钱包手机充值多久到账？
为什么手机话费充值已扣款话费未到账？	为什么手机话费充值已扣款话费未到账？
充值时手机号码输错了怎么办？	充值时手机号码输错了怎么办？
银联钱包手机充值提供发票吗？	银联钱包手机充值提供发票吗？
银联钱包可以信用卡转给储蓄卡吗？	银联钱包可以信用卡转给储蓄卡吗？
银联钱包转账要手续费吗？	银联钱包转账要手续费吗？
银联钱包银行卡转账手续费多少？	银联钱包转账要手续费吗？
您好，请问手机银联转账需要手续费吗	银联钱包转账要手续费吗？
银联钱包支持哪些银行转账？	银联钱包支持哪些银行转账？
银联钱包从某银行转包某银行为什么不支持了呢？	银联钱包支持哪些银行转账？
银联钱包从招行转给中国银行为什么不支持了呢？	银联钱包支持哪些银行转账？
银联钱包转账多久能到账？	银联钱包转账多久能到账？
“我是收银员”激活不了？	“我是收银员”激活不了？
我银联钱包收银员激活不了	“我是收银员”激活不了？
“我是收银员”是什么功能？	“我是收银员”是什么功能？
如何使用拍拍卡?	如何使用拍拍卡?
拍拍卡支持哪些卡片？	拍拍卡支持哪些卡片？
拍卡电子现金圈存出错如何处理？	拍卡电子现金圈存出错如何处理？
卡片最近使用记录包含哪些记录？	卡片最近使用记录包含哪些记录？
什么是拍卡转账？	什么是拍卡转账？
拍卡转账限额是多少？	拍卡转账限额是多少？
可以网上进行实名认证吗？	可以网上进行实名认证吗？
什么是扫码支付？	什么是扫码支付？
什么叫扫码支付	什么是扫码支付？
扫码付是什么	什么是扫码支付？
怎么使用扫码支付？	怎么使用扫码支付？
扫码付要怎么用	怎么使用扫码支付？
如何使用扫码付	怎么使用扫码支付？
付款码交易有限额吗？	付款码交易有限额吗？
用付款码支付有额度限制吗	付款码交易有限额吗？
用付款码最多能付多少钱	付款码交易有限额吗？
使用付款码需要具备什么条件呢？	使用付款码需要具备什么条件呢？
满足什么条件才能用付款码付款	使用付款码需要具备什么条件呢？
使用付款码有什么要求吗	使用付款码需要具备什么条件呢？
使用付款码支付要收手续费吗？	使用付款码支付要收手续费吗？
扫码付要收费吗	使用付款码支付要收手续费吗？
扫码支付支持哪些网上商户呢？	扫码支付支持哪些网上商户呢？
哪些网站可以用扫码付	扫码支付支持哪些网上商户呢？
网上哪些商户支持扫码支付	扫码支付支持哪些网上商户呢？
怎么设置扫码支付的小额免密功能？	怎么设置扫码支付的小额免密功能？
扫码支付的小额免密功能如何设置？	怎么设置扫码支付的小额免密功能？
扫码支付可以设置小额免密功能吗？	怎么设置扫码支付的小额免密功能？
如何设扫码付的小额免密功能	怎么设置扫码支付的小额免密功能？
扫码付能设置成小金额不用输入免密的吗	怎么设置扫码支付的小额免密功能？
扫码付怎么设置小额免密	怎么设置扫码支付的小额免密功能？
扫码付的小额免密怎么设置？	怎么设置扫码支付的小额免密功能？
怎么查询银联红包的交易记录？	怎么查询银联红包的交易记录？
银联红包的交易记录如何查询	怎么查询银联红包的交易记录？
我想查询银联红包的交易记录	怎么查询银联红包的交易记录？
红包的交易记录能查吗	怎么查询银联红包的交易记录？
如何查询银联红包交易记录	怎么查询银联红包的交易记录？
怎么注册银联钱包？	怎么注册银联钱包？
如何注册银联钱包	怎么注册银联钱包？
银联钱包怎么注册	怎么注册银联钱包？
在哪里能注册银联钱包	怎么注册银联钱包？
银联红包可以在哪些商户使用？	银联红包可以在哪些商户使用？
请问哪些商家可以使用银联红包	银联红包可以在哪些商户使用？
哪些商户支持使用银联红包	银联红包可以在哪些商户使用？
哪些店可以用银联红包	银联红包可以在哪些商户使用？
我在哪里能用银联红包啊？	银联红包可以在哪些商户使用？
银联红包在哪能用	银联红包可以在哪些商户使用？
银联钱包优惠券一般什么时候发放？	银联钱包优惠券一般什么时候发放？
请问优惠券发放有具体时间吗？	银联钱包优惠券一般什么时候发放？
银联钱包的优惠券什么时候放啊	银联钱包优惠券一般什么时候发放？
银联钱包优惠券一般什么时候能抢	银联钱包优惠券一般什么时候发放？
云闪付APP的登录用户名是什么？	云闪付APP的登录用户名是什么？
如何登录云闪付APP	云闪付APP的登录用户名是什么？
使用云闪付APP需要登录吗？	使用云闪付APP需要登录吗？
不登录，可以使用云闪付APP吗？	使用云闪付APP需要登录吗？
云闪付卡有限额吗？	云闪付卡有限额吗？
云闪付卡最多能支付多少钱？	云闪付卡有限额吗？
注销主卡对云闪付卡有影响吗？	注销主卡对云闪付卡有影响吗？
云闪付APP如何参加活动？	云闪付APP如何参加活动？
云闪付APP能用红包吗？	云闪付APP如何参加活动？
我最多能申请多少张云闪付APP的闪付卡？	云闪付APP
一部手机上最多能绑定多少张云闪付APP虚拟卡？	云闪付APP
云闪付APP中申请了云闪付卡，但手机没有NFC功能，可以使用吗？	云闪付APP中申请了云闪付卡，但手机没有NFC功能，可以使用吗？
如果手机不支持NFC，能用云闪付吗？	云闪付APP中申请了云闪付卡，但手机没有NFC功能，可以使用吗？
手机不支持NFC，我想用云闪付APP，要怎么用呢？	云闪付APP中申请了云闪付卡，但手机没有NFC功能，可以使用吗？
可以添加他人的银行卡吗？添加后如何删除？	可以添加他人的银行卡吗？添加后如何删除？
如何注销云闪付APP的用户名？	如何注销云闪付APP的用户名？
什么是云闪付APP？	什么是云闪付APP
云闪付APP是你们银联的业务吗？	什么是云闪付APP
使用云闪付APP对手机有什么条件？	使用云闪付APP对手机有什么条件？
云闪付APP有什么限制要求在手机系统上？	使用云闪付APP对手机有什么条件？
云闪付APP目前哪些操作系统及机型支持线下交易	云闪付APP目前哪些操作系统及机型支持线下交易
云闪付APP线下交易目前支持哪些手机型号？	云闪付APP目前哪些操作系统及机型支持线下交易
云闪付APP有哪些支付方式	云闪付APP有哪些支付方式
云闪付APP能在超市或者商场这种实体店做交易嘛？	云闪付APP有哪些支付方式
云闪付APP能在网站上付款嘛？	云闪付APP有哪些支付方式
云闪付APP目前支持哪些银行卡申请HCE云闪付卡？	云闪付APP目前支持哪些银行卡申请HCE云闪付卡？
云闪付APP现在有哪些银行的卡能申请HCE云闪付的卡？	云闪付APP目前支持哪些银行卡申请HCE云闪付卡？
云闪付APP客户端的云卡被删除，其他客户端（银联钱包、银行）是否也被删除？	云闪付APP客户端的云卡被删除，其他客户端是否也被删除
云闪付APP客户端的云卡被删除，银联钱包是否也被删除？	云闪付APP客户端的云卡被删除，其他客户端是否也被删除
云闪付APP客户端的云卡被删除，银行是否也被删除？	云闪付APP客户端的云卡被删除，其他客户端是否也被删除
云闪付APP客户端的云卡被删除会影响其他客户端（银联钱包、银行）吗？	云闪付APP客户端的云卡被删除，其他客户端是否也被删除
云闪付APP客户端的云卡被删除会影响银联钱包吗？	云闪付APP客户端的云卡被删除，其他客户端是否也被删除
云闪付APP客户端的云卡被删除会影响银行吗？	云闪付APP客户端的云卡被删除，其他客户端是否也被删除
怎样下载云闪付APP？	怎样下载云闪付APP？
在哪里可以下载云闪付APP？	怎样下载云闪付APP？
我用什么下载云闪付APP啊？	怎样下载云闪付APP？
云闪付APP中为什么显示其他APP的卡？	云闪付APP中为什么显示其他APP的卡？
我没在云闪付APP上绑定过工商银行的卡，为什么会显示？	云闪付APP中为什么显示其他APP的卡？
我在银行客户端中申请了卡为什么没有在APP中显示出来？	我在银行客户端中申请了卡为什么没有在APP中显示出来？
我在HUAWEIPAY中申请了卡为什么没有在APP中显示出来？	我在银行客户端中申请了卡为什么没有在APP中显示出来？
我在SAMSUNGPAY中申请了卡为什么没有在APP中显示出来？	我在银行客户端中申请了卡为什么没有在APP中显示出来？
通过手机银行申请的云闪付卡，如果手机银行被卸载了，那么通过云闪付APP还能看到吗？	通过手机银行申请的云闪付卡，如果手机银行被卸载了，那么通过云闪付APP还能看到吗？
手机银行已经被卸载了，那么云闪付APP能否显示通过手机银行申请的云闪付卡？	通过手机银行申请的云闪付卡，如果手机银行被卸载了，那么通过云闪付APP还能看到吗？
支持云闪付线上支付的商户APP为什么没有云闪付的支付入口	支持云闪付线上支付的商户APP为什么没有云闪付的支付入口
在支持云闪付线上支付商户的APP里如何使用云闪付付款？我怎么找不到？	支持云闪付线上支付的商户APP为什么没有云闪付的支付入口
云闪付APP为什么无法删除云闪付卡？	云闪付APP为什么无法删除云闪付卡？
云闪付APP使用起来支付的时候特别慢，这是为什么？	云闪付APP为什么无法删除云闪付卡？
我在云闪付APP上删除云闪付卡，但是不能删除，这是为什么？	云闪付APP为什么无法删除云闪付卡？
云闪付APP为什么无法查看此前添加的云闪付卡？	云闪付APP为什么无法查看此前添加的云闪付卡？
云闪付APP为什么看不了之前添加的云闪付卡？	云闪付APP为什么无法查看此前添加的云闪付卡？
我手机SIM卡换过，然后在云闪付APP里就看不到之前添加的云闪付卡了，这是为什么？	云闪付APP为什么无法查看此前添加的云闪付卡？
什么是SAMSUNGPAY？	什么是SAMSUNGPAY？
SAMSUNGPAY是什么？	什么是SAMSUNGPAY？
SAMSUNGPAY是怎么工作的？	SAMSUNGPAY是怎么工作的？
SAMSUNGPAY是通过什么实现交易的？	SAMSUNGPAY是怎么工作的？
请问哪些手机支持SAMSUNGPAY	请问哪些手机支持SAMSUNGPAY
请问A手机支持SAMSUNGPAY吗？	请问哪些手机支持SAMSUNGPAY
哪些手机能用华为SAMSUNGPAY？	请问哪些手机支持SAMSUNGPAY
我的手机是小米能使用SAMSUNGPAY？	请问哪些手机支持SAMSUNGPAY
什么手机能使用三星PAY	请问哪些手机支持SAMSUNGPAY
哪种手机能用三星PAY	请问哪些手机支持SAMSUNGPAY
在国外可以使用SAMSUNGPAY支付吗？	在国外可以使用SAMSUNGPAY支付吗？
SAMSUNGPAY可以在国外使用吗？	在国外可以使用SAMSUNGPAY支付吗？
日本可以使用SAMSUNGPAY吗？	在国外可以使用SAMSUNGPAY支付吗？
三星PAY能在境外用吗	在国外可以使用SAMSUNGPAY支付吗？
海外可以用三星PAY购物吗	在国外可以使用SAMSUNGPAY支付吗？
非大陆地区可以用三星PAY吗	在国外可以使用SAMSUNGPAY支付吗？
请问SAMSUNGPAY消费限额是多少？	请问SAMSUNGPAY消费限额是多少？
请问SAMSUNGPAY消费有金额限制吗？	请问SAMSUNGPAY消费限额是多少？
SAMSUNGPAY有消费额度要求吗	请问SAMSUNGPAY消费限额是多少？
SAMSUNGPAY最多能付多少钱	请问SAMSUNGPAY消费限额是多少？
申请SAMSUNGPAY等待时间过长，怎么办？	申请SAMSUNGPAY等待时间过长，怎么办？
为什么申请SAMSUNGPAY要那么长时间？	申请SAMSUNGPAY等待时间过长，怎么办？
申请个SAMSUNGPAY怎么等这么久	申请SAMSUNGPAY等待时间过长，怎么办？
申请SAMSUNGPAY等得也太长时间了吧	申请SAMSUNGPAY等待时间过长，怎么办？
请问SAMSUNGPAY的短信验证码有效期是多久	请问SAMSUNGPAY的短信验证码有效期是多久
SAMSUNGPAY的短信验证码有有效期吗？	请问SAMSUNGPAY的短信验证码有效期是多久
SAMSUNGPAY短信验证码多久有效	请问SAMSUNGPAY的短信验证码有效期是多久
请问为什么收不到SAMSUNGPAY的短信验证码	请问为什么收不到SAMSUNGPAY的短信验证码
收不到SAMSUNGPAY的短信验证码，怎么办？	请问为什么收不到SAMSUNGPAY的短信验证码
我怎么收不到SAMSUNGPAY的短信验证	请问为什么收不到SAMSUNGPAY的短信验证码
SAMSUNGPAY显示图片和实际图片不符	SAMSUNGPAY显示图片和实际图片不符
请问为什么SAMSUNGPAY显示图片和实际图片不符	SAMSUNGPAY显示图片和实际图片不符
SAMSUNGPAY显示图片为什么和实际图片不符	SAMSUNGPAY显示图片和实际图片不符
对申请SAMSUNGPAY的条款和条件有疑义	对申请SAMSUNGPAY的条款和条件有疑义
如何查询SAMSUNGPAY卡号？	如何查询SAMSUNGPAY卡号？
SAMSUNGPAY卡号如何查询	如何查询SAMSUNGPAY卡号？
我想查询我的SAMSUNGPAY卡号	如何查询SAMSUNGPAY卡号？
SAMSUNGPAY卡号怎么查	如何查询SAMSUNGPAY卡号？
一张银行卡可以申请几张SAMSUNGPAY云闪付卡？一部手机可以申请几张SAMSUNGPAY云闪付卡？	一张银行卡可以申请几张SAMSUNGPAY云闪付卡？一部手机可以申请几张SAMSUNGPAY云闪付卡？
一张银行卡可以申请几张SAMSUNGPAY云闪付卡？	一张银行卡可以申请几张SAMSUNGPAY云闪付卡？一部手机可以申请几张SAMSUNGPAY云闪付卡？
一个手机可以申请几张SAMSUNGPAY云闪付卡？	一张银行卡可以申请几张SAMSUNGPAY云闪付卡？一部手机可以申请几张SAMSUNGPAY云闪付卡？
一个手机申请SAMSUNGPAY云闪付卡有张数限制吗？	一张银行卡可以申请几张SAMSUNGPAY云闪付卡？一部手机可以申请几张SAMSUNGPAY云闪付卡？
一部手机最多能申请几张SAMSUNGPAY云闪付卡	一张银行卡可以申请几张SAMSUNGPAY云闪付卡？一部手机可以申请几张SAMSUNGPAY云闪付卡？
如何设置SAMSUNGPAY默认卡？	如何设置SAMSUNGPAY默认卡？
请问可以设置SAMSUNGPAY默认卡支付吗？	如何设置SAMSUNGPAY默认卡？
请问手机上有多张SAMSUNGPAY云闪付卡，支付时是哪张卡支付？	如何设置SAMSUNGPAY默认卡？
SAMSUNGPAY的时候能选择只用一张卡付款吗	如何设置SAMSUNGPAY默认卡？
您好，查询我的实体卡关联了多少张SAMSUNGPAY云闪付卡	您好，查询我的实体卡关联了多少张SAMSUNGPAY云闪付卡
您好，我想知道我的A银行卡关联了几张SAMSUNGPAY云闪付卡	您好，查询我的实体卡关联了多少张SAMSUNGPAY云闪付卡
我的银行卡申请了多少张SAMSUNGPAY云闪付卡怎么查	您好，查询我的实体卡关联了多少张SAMSUNGPAY云闪付卡
实体卡已更换新卡，SAMSUNGPAY客户端里该如何操作？	实体卡已更换新卡，SAMSUNGPAY客户端里该如何操作？
我银行卡换了新卡，手机上SAMSUNGPAY云闪付卡要如何操作？	实体卡已更换新卡，SAMSUNGPAY客户端里该如何操作？
银行卡卡号变了，SAMSUNGPAY要怎么办	实体卡已更换新卡，SAMSUNGPAY客户端里该如何操作？
如何注销（即删除）SAMSUNGPAY云闪付卡？	如何注销SAMSUNGPAY云闪付卡？
如何即删除SAMSUNGPAY云闪付卡？	如何注销SAMSUNGPAY云闪付卡？
我要注销SAMSUNGPAY？	如何注销SAMSUNGPAY云闪付卡？
SAMSUNGPAY要如何注销？	如何注销SAMSUNGPAY云闪付卡？
SAMSUNGPAY闪付卡要怎么删除	如何注销SAMSUNGPAY云闪付卡？
我不要用SAMSUNGPAY了，需要注销操作吗	如何注销SAMSUNGPAY云闪付卡？
SAMSUNGPAY能注销吗	如何注销SAMSUNGPAY云闪付卡？
客户端上无法删除云闪付卡怎么办？	客户端上无法删除云闪付卡怎么办？
手机客户端上无法注销云闪付卡怎么办？	客户端上无法删除云闪付卡怎么办？
云闪付卡怎么删不掉	客户端上无法删除云闪付卡怎么办？
为什么不能注销云闪付卡？	客户端上无法删除云闪付卡怎么办？
我在注销云闪付卡，但是不能注销，为什么	客户端上无法删除云闪付卡怎么办？
我想删除手机上的云闪付卡，但是删除不了，是怎么了	客户端上无法删除云闪付卡怎么办？
如何挂失SAMSUNGPAY？如何解挂SAMSUNGPAY？	如何挂失SAMSUNGPAY？如何解挂SAMSUNGPAY？
我想挂失SAMSUNGPAY闪付卡	如何挂失SAMSUNGPAY？如何解挂SAMSUNGPAY？
我想解挂SAMSUNGPAY	如何挂失SAMSUNGPAY？如何解挂SAMSUNGPAY？
请问怎么挂失SAMSUNGPAY	如何挂失SAMSUNGPAY？如何解挂SAMSUNGPAY？
请问怎么解挂SAMSUNGPAY	如何挂失SAMSUNGPAY？如何解挂SAMSUNGPAY？
如实体卡已挂失，那么云闪付卡是否还需挂失？注销、挂失、锁定实体卡后云闪付卡还能用吗？	如实体卡已挂失，那么云闪付卡是否还需挂失？注销、挂失、锁定实体卡后云闪付卡还能用吗？
注销实体卡，其关联的云闪付卡还能用吗？	如实体卡已挂失，那么云闪付卡是否还需挂失？注销、挂失、锁定实体卡后云闪付卡还能用吗？
注销云闪付卡，关联的实体卡还能用吗？	如实体卡已挂失，那么云闪付卡是否还需挂失？注销、挂失、锁定实体卡后云闪付卡还能用吗？
请问银行卡挂失了，申请的云闪付卡还能使用吗	如实体卡已挂失，那么云闪付卡是否还需挂失？注销、挂失、锁定实体卡后云闪付卡还能用吗？
请问银行卡注销后，申请的云闪付卡也注销了吗	如实体卡已挂失，那么云闪付卡是否还需挂失？注销、挂失、锁定实体卡后云闪付卡还能用吗？
请问银行卡被锁了，影响云闪付卡使用吗	如实体卡已挂失，那么云闪付卡是否还需挂失？注销、挂失、锁定实体卡后云闪付卡还能用吗？
我银行卡已经挂失了，那云闪付卡还能用吗	如实体卡已挂失，那么云闪付卡是否还需挂失？注销、挂失、锁定实体卡后云闪付卡还能用吗？
我的卡丢了所以我冻结了卡片，云闪付卡是不是也不能用了	如实体卡已挂失，那么云闪付卡是否还需挂失？注销、挂失、锁定实体卡后云闪付卡还能用吗？
为什么打开客户端，云闪付卡被标记为“正在删除”	为什么打开客户端，云闪付卡被标记为“正在删除”
为什么我的云闪付卡被标记正在删除	为什么打开客户端，云闪付卡被标记为“正在删除”
云闪付卡显示正在删除是怎么了	为什么打开客户端，云闪付卡被标记为“正在删除”
我什么都没操作但是云闪付卡怎么会显示正在删除	为什么打开客户端，云闪付卡被标记为“正在删除”
为什么云闪付卡自动被删除	为什么云闪付卡自动被删除
我没删除过，但是云闪付卡就被删除了是为什么	为什么云闪付卡自动被删除
云闪付卡为什么会在我自己没删除的情况下就被自动删除了	为什么云闪付卡自动被删除
设备交去维修或退货，但是没有删除或暂停卡怎么办？	设备交去维修或退货，但是没有删除或暂停卡怎么办？
手机交去维修了，忘记删除云闪付卡，请问有怎么办？	设备交去维修或退货，但是没有删除或暂停卡怎么办？
手机交去维修了，忘记删除云闪付卡，会有风险吗？	设备交去维修或退货，但是没有删除或暂停卡怎么办？
手机送去修了，但是没有暂定卡片是不是不安全？	设备交去维修或退货，但是没有删除或暂停卡怎么办？
可以通过备份恢复来恢复已经申请的SAMSUNGPAY闪付卡	可以通过备份恢复来恢复已经申请的SAMSUNGPAY闪付卡
SAMSUNGPAY闪付卡能备份恢复吗	可以通过备份恢复来恢复已经申请的SAMSUNGPAY闪付卡
请问哪些商户使用SAMSUNGPAY支付？	请问哪些商户使用SAMSUNGPAY支付？
我想知道哪些商户可以使用SAMSUNGPAY？	请问哪些商户使用SAMSUNGPAY支付？
某某商户可以使用SAMSUNGPAY吗？	请问哪些商户使用SAMSUNGPAY支付？
SAMSUNGPAY可以在哪些商户使用？	请问哪些商户使用SAMSUNGPAY支付？
支持SAMSUNGPAY的商户有哪些？	请问哪些商户使用SAMSUNGPAY支付？
哪些店能用三星PAY	请问哪些商户使用SAMSUNGPAY支付？
什么是HUAWEIPAY？	什么是HUAWEIPAY？
什么是华为PAY？	什么是HUAWEIPAY？
HUAWEIPAY是怎么工作的？	HUAWEIPAY是怎么工作的？
华为PAY是怎么工作的？	HUAWEIPAY是怎么工作的？
华为PAY是通过什么是实现交易的？	HUAWEIPAY是怎么工作的？
什么手机支持HUAWEIPAY？	什么手机支持HUAWEIPAY？
我的手机是苹果手机，支持HUAWEIPAY吗？	什么手机支持HUAWEIPAY？
哪些手机能用华为PAY吗？	什么手机支持HUAWEIPAY？
华为的哪些型号能用华为PAY	什么手机支持HUAWEIPAY？
HUAWEIPAY云闪付卡消费有额度限制吗	HUAWEIPAY云闪付卡消费有额度限制吗
HUAWEIPAY云闪付卡一次最多能付多少钱	HUAWEIPAY云闪付卡消费有额度限制吗
申请云闪付卡等待时间过长	申请云闪付卡等待时间过长
申请云卡时间太长了	申请云闪付卡等待时间过长
申请个云闪付卡怎么需要那么久？	申请云闪付卡等待时间过长
请问申请HUAWEIPAY的短信验证码有效期是多久？	请问申请HUAWEIPAY的短信验证码有效期是多久？
我在申请HUAWEIPAY，为什么一直收不到短信验证码？	我在申请HUAWEIPAY，为什么一直收不到短信验证码？
云卡图片和实体卡图片不一样	云卡图片和实体卡图片不一样
你们这个条款和条件是有问题的该怎么办？	你们这个条款和条件是有问题的该怎么办？
我对卡的条款有疑问，该找谁？	你们这个条款和条件是有问题的该怎么办？
HUAWEIPAY云卡卡号能查吗	HUAWEIPAY云卡卡号能查吗
我想知道HUAWEIPAY云卡卡号怎么查	HUAWEIPAY云卡卡号能查吗
在哪里能看到HUAWEIPAY云卡卡号	HUAWEIPAY云卡卡号能查吗
一张银行卡可以有几张HUAWEIPAY云闪付卡	一张银行卡可以有几张HUAWEIPAY云闪付卡
一张银行卡最多能申请几张HUAWEIPAY云卡	一张银行卡可以有几张HUAWEIPAY云闪付卡
一台华为手机最多能申请几张HUAWEIPAY云卡	一张银行卡可以有几张HUAWEIPAY云闪付卡
想设置一张卡为HUAWEIPAY的默认付款卡，怎么操作	想设置一张卡为HUAWEIPAY的默认付款卡，怎么操作
有好几张HUAWEIPAY云卡，默认哪张卡付款呢	想设置一张卡为HUAWEIPAY的默认付款卡，怎么操作
我想看我一张银行卡申请了多少张HUAWEIPAY云闪付卡	我想看我一张银行卡申请了多少张HUAWEIPAY云闪付卡
一张实体卡一共关联了几张HUAWEIPAY云闪付卡怎么查	我想看我一张银行卡申请了多少张HUAWEIPAY云闪付卡
银行卡换了，怎么在云闪付客户端里操作啊	银行卡换了，怎么在云闪付客户端里操作啊
手机坏了怎么办	手机坏了怎么办
HUAWEIPAY云闪付卡要圈存钱进去吗	HUAWEIPAY云闪付卡要圈存钱进去吗
需要圈存钱到HUAWEIPAY云闪付卡里吗	HUAWEIPAY云闪付卡要圈存钱进去吗
HUAWEIPAY云闪付卡要先圈存才能用吗	HUAWEIPAY云闪付卡要圈存钱进去吗
POS交易时要联网吗	POS交易时要联网吗
POS交易时手机要打开网络吗	POS交易时要联网吗
手机必须联网才用HUAWEIPAY云闪付能交易吗	POS交易时要联网吗
关机了可以在POS上交易吗	关机了可以在POS上交易吗
为什么签购单上的卡号和我的银行卡号不一样	为什么签购单上的卡号和我的银行卡号不一样
小票上的卡号和我的银行卡号不一样有什么影响吗	为什么签购单上的卡号和我的银行卡号不一样
POS打出来的卡号和我的银行卡号不一样	为什么签购单上的卡号和我的银行卡号不一样
我的银行卡都有密码的，为什么我做低于<数字>元的交易不要输密码？	我的银行卡都有密码的，为什么我做低于<数字>元的交易不要输密码？
为什么我付款<数字>元不要输密码？	我的银行卡都有密码的，为什么我做低于<数字>元的交易不要输密码？
为什么我付款<数字>元（低于<数字>元）不要签字？	我的银行卡都有密码的，为什么我做低于<数字>元的交易不要输密码？
我的银行卡都有密码的，为什么我做<数字>元的交易不要输密码？	我的银行卡都有密码的，为什么我做低于<数字>元的交易不要输密码？
为什么我的指纹验证不能用了	手机指纹验证或解锁密码验证不起作用，怎么办？
为什么我的解锁密码不能用了	手机指纹验证或解锁密码验证不起作用，怎么办？
为什么我用指纹无法解锁	手机指纹验证或解锁密码验证不起作用，怎么办？
为什么我输入密码验证不能解锁	手机指纹验证或解锁密码验证不起作用，怎么办？
我用完云闪付付完钱但是不想要这东西了想退货怎么办	我用完云闪付付完钱但是不想要这东西了想退货怎么办
我用云闪付做了交易想要退款	我用完云闪付付完钱但是不想要这东西了想退货怎么办
退款要怎么做	我用完云闪付付完钱但是不想要这东西了想退货怎么办
退款会退到哪张卡上	退款会退到哪张卡上
退款是原路返回吗	退款会退到哪张卡上
退款是退回到我付款的卡上吗	退款会退到哪张卡上
使用新申请的云闪付卡，是否可享受其关联的实体卡的相关权益？	使用新申请的云闪付卡，是否可享受其关联的实体卡的相关权益？
POS交易后银行会发短信提醒吗	POS交易后银行会发短信提醒吗
我怎么查POS交易后银行会不会发短信通知我？	POS交易后银行会发短信提醒吗
这个华为发我的邮件什么意思啊	这个华为发我的邮件什么意思啊
这个邮件里面说的我有点疑问怎么办	这个华为发我的邮件什么意思啊
手机更新了系统然后华为PAY出问题了怎么办	手机更新了系统然后华为PAY出问题了怎么办
系统更新以后华为PAY有点问题怎么办	手机更新了系统然后华为PAY出问题了怎么办
关于华为PAY的技术问题该找谁	关于华为PAY的技术问题该找谁
关于华为PAY的技术我想了解更多一些	关于华为PAY的技术问题该找谁
华为PAY的技术问题你们负责吗	关于华为PAY的技术问题该找谁
华为PAY安全吗	华为PAY安全吗
HUAWEIPAY安全吗	华为PAY安全吗
HUAWEIPAY是否安全？	华为PAY安全吗
华为PAY安不安全	华为PAY安全吗
我用华为PAY付款，华为那边会有我的银行卡信息吗	我用华为PAY付款，华为那边会有我的银行卡信息吗
华为会保留我的用卡信息吗	我用华为PAY付款，华为那边会有我的银行卡信息吗
华为会记录和保留我的交易信息和银行卡信息吗	我用华为PAY付款，华为那边会有我的银行卡信息吗
华为会留存我的银行卡和交易信息吗	我用华为PAY付款，华为那边会有我的银行卡信息吗
为什么我的中信卡不能用过华为PAY参加活动	为什么我的中信卡不能用过华为PAY参加活动
用中信卡通过华为PAY做交易为什么参不了活动	为什么我的中信卡不能用过华为PAY参加活动
招行的云闪付卡能参加活动吗	招行的云闪付卡能参加活动吗
用招行申请云卡能享受到优惠吗	招行的云闪付卡能参加活动吗
可以在哪些商户使用HUAWEIPAY支付？	可以在哪些商户使用HUAWEIPAY支付？
哪些地方能用华为PAY	可以在哪些商户使用HUAWEIPAY支付？
什么店能用华为PAY	可以在哪些商户使用HUAWEIPAY支付？
怎么看一家店能不能用华为PAY	可以在哪些商户使用HUAWEIPAY支付？
随便什么店都能用华为PAY吗	可以在哪些商户使用HUAWEIPAY支付？
怎么用云闪付卡	怎么用云闪付卡
云闪付卡到底怎么使用呢	怎么用云闪付卡
云闪付卡要怎么用	怎么用云闪付卡
如何使用SAMSUNGPAY闪付卡？	如何使用SAMSUNGPAY闪付卡？
请问怎么使用三星PAY？	如何使用SAMSUNGPAY闪付卡？
三星PAY的使用流程	如何使用SAMSUNGPAY闪付卡？
我要怎么用三星PAY	如何使用SAMSUNGPAY闪付卡？
三星PAY如何使用	如何使用SAMSUNGPAY闪付卡？
客户端里为什么多了一张未申请过的云闪付卡	客户端里为什么多了一张未申请过的云闪付卡
为什么我手机客户端出现一张不是我申请的云闪付卡	客户端里为什么多了一张未申请过的云闪付卡
使用SAMSUNGPAY闪付卡是否需要密码？	使用SAMSUNGPAY闪付卡是否需要密码？
三星PAY交易需要密码吗？	使用SAMSUNGPAY闪付卡是否需要密码？
三星PAY交易可以不输入密码就可以交易吗？	使用SAMSUNGPAY闪付卡是否需要密码？
三星PAY要输入密码吗	使用SAMSUNGPAY闪付卡是否需要密码？
请问使用SAMSUNGPAY闪付卡是否需要圈存资金至申请的虚拟银行卡账户中	请问使用SAMSUNGPAY闪付卡是否需要圈存资金至申请的虚拟银行卡账户中
请问使用SAMSUNGPAY需要圈存吗？	请问使用SAMSUNGPAY闪付卡是否需要圈存资金至申请的虚拟银行卡账户中
请问使用SAMSUNGPAY需要圈钱到云闪付卡里面吗？	请问使用SAMSUNGPAY闪付卡是否需要圈存资金至申请的虚拟银行卡账户中
SAMSUNGPAY交易时手机需要联网吗？	SAMSUNGPAY交易时手机需要联网吗？
请问没网可以使用SAMSUNGPAY交易吗？	SAMSUNGPAY交易时手机需要联网吗？
请问在POS机上SAMSUNGPAY，手机没网可以用吗？	SAMSUNGPAY交易时手机需要联网吗？
手机关机可以进行SAMSUNGPAY交易吗？	手机关机可以进行SAMSUNGPAY交易吗？
手机关机还可以使用三星PAY吗？	手机关机可以进行SAMSUNGPAY交易吗？
请问使用云闪付手机如何设置？	请问使用云闪付手机如何设置？
使用三星PAY在手机需要如何设置	请问使用云闪付手机如何设置？
SAMSUNGPAY交易打单的卡号为什么与我的银行卡不一样？	SAMSUNGPAY交易打单的卡号为什么与我的银行卡不一样？
为什么SAMSUNGPAY交易打单的卡号和我银行卡号不一致	SAMSUNGPAY交易打单的卡号为什么与我的银行卡不一样？
SAMSUNGPAY小票上的卡号和我的银行卡卡号是不一样的，这是为什么	SAMSUNGPAY交易打单的卡号为什么与我的银行卡不一样？
SAMSUNGPAY指纹验证或解锁密码验证不起作用	SAMSUNGPAY指纹验证或解锁密码验证不起作用
SAMSUNGPAY指纹验证为什么没反应	SAMSUNGPAY指纹验证或解锁密码验证不起作用
SAMSUNGPAY指纹验证出现问题了	SAMSUNGPAY指纹验证或解锁密码验证不起作用
我用自己的指纹居然无法解锁SAMSUNGPAY，怎么办	SAMSUNGPAY指纹验证或解锁密码验证不起作用
我用SAMSUNGPAY交易的，如何退款？	我用SAMSUNGPAY交易的，如何退款？
SAMSUNGPAY交易后退款如何操作	我用SAMSUNGPAY交易的，如何退款？
我是用SAMSUNGPAY交易的，我想怎么退款？	我用SAMSUNGPAY交易的，如何退款？
买东西的时候用的三星PAY，现在要退，怎么退	我用SAMSUNGPAY交易的，如何退款？
我用SAMSUNGPAY交易的，退款是退至哪张卡上？	我用SAMSUNGPAY交易的，退款是退至哪张卡上？
我用SAMSUNGPAY交易的，退款期间将申请的虚拟卡删除了的话，会影响入账吗？	我用SAMSUNGPAY交易的，退款是退至哪张卡上？
SAMSUNGPAY交易的，退款会退到银行卡上吗？	我用SAMSUNGPAY交易的，退款是退至哪张卡上？
买的时候用的三星PAY，那退的时候还是退回到原来卡上吗	我用SAMSUNGPAY交易的，退款是退至哪张卡上？
MST交易是否受IC卡降级交易影响？	MST交易是否受IC卡降级交易影响？
IC卡降级交易对MST交易有影响吗？	MST交易是否受IC卡降级交易影响？
使用新申请的SAMSUNGPAY消费，是否有积分，如何积分？	使用新申请的SAMSUNGPAY消费，是否有积分，如何积分？
我用SAMSUNGPAY交易有积分吗？	使用新申请的SAMSUNGPAY消费，是否有积分，如何积分？
SAMSUNGPAY交易积分和银行卡交易积分一样吗？	使用新申请的SAMSUNGPAY消费，是否有积分，如何积分？
使用新申请的SAMSUNGPAY，是否可享受其关联的实体卡的相关权益？	使用新申请的SAMSUNGPAY，是否可享受其关联的实体卡的相关权益？
银行卡享受的权益，申请的SAMSUNGPAY闪付卡可以享受吗？	使用新申请的SAMSUNGPAY，是否可享受其关联的实体卡的相关权益？
SAMSUNGPAY在POS交易后银行会发送扣交款短信提醒吗	SAMSUNGPAY在POS交易后银行会发送扣交款短信提醒吗
SAMSUNGPAY交易后会有短信通知吗？	SAMSUNGPAY在POS交易后银行会发送扣交款短信提醒吗
用三星PAY付款，银行卡扣钱成功会有短信提醒吗	SAMSUNGPAY在POS交易后银行会发送扣交款短信提醒吗
为什么收到的SAMSUNGPAY关于功能、服务或交易的电子邮件？	为什么收到的SAMSUNGPAY关于功能、服务或交易的电子邮件？
别人用我的卡申请云闪付卡怎么办？	别人用我的卡申请云闪付卡怎么办？
我的银行卡被别人申请了云闪付卡怎么办？	别人用我的卡申请云闪付卡怎么办？
为什么我的银行卡被别人申请了云闪付卡？	别人用我的卡申请云闪付卡怎么办？
别人解锁密码盗用我的云闪付卡怎么办？	别人解锁密码盗用我的云闪付卡怎么办？
因别人解锁密码，导致我的云闪付卡被盗用如何处理？	别人解锁密码盗用我的云闪付卡怎么办？
有人破解了我的密码，刷了我的云闪付卡，怎么追回钱	别人解锁密码盗用我的云闪付卡怎么办？
更新系统是否会改变云闪付卡的状态？	更新系统是否会改变云闪付卡的状态？
手机系统更新了，云闪付卡状态会改变吗？	更新系统是否会改变云闪付卡的状态？
手机系统更新了，对云闪付卡有影响吗？	更新系统是否会改变云闪付卡的状态？
SAMSUNGPAY是否安全？	SAMSUNGPAY是否安全？
SAMSUNGPAY安全吗？	SAMSUNGPAY是否安全？
三星是否会保存交易记录及银行卡信息？	三星是否会保存交易记录及银行卡信息？
我用SAMSUNGPAY，三星会保存交易记录和银行卡信息吗？	三星是否会保存交易记录及银行卡信息？
我用三星PAY付款，三星会有我的信息吗	三星是否会保存交易记录及银行卡信息？
三星公司会收集卡号使用三星PAY的记录吗	三星是否会保存交易记录及银行卡信息？
SAMSUNGPAY是否可以支持ATM取款？	SAMSUNGPAY是否可以支持ATM取款？
SAMSUNGPAY可以在ATM取款吗？	SAMSUNGPAY是否可以支持ATM取款？
我没带卡要到ATM取款，能直接用三星PAY吗	SAMSUNGPAY是否可以支持ATM取款？
三星PAY支持无卡取现吗	SAMSUNGPAY是否可以支持ATM取款？
线上可以在哪些商户使用设备卡（云闪付卡）支付？	线上可以在哪些商户使用设备卡支付？
设备卡（云闪付卡）可以在哪些网上商家支付？	线上可以在哪些商户使用设备卡支付？
哪些网上商家支持设备卡（云闪付卡）支付	线上可以在哪些商户使用设备卡支付？
网购能用云闪付卡付款吗	线上可以在哪些商户使用设备卡支付？
现在的电商平台能用云闪付卡付款吗	线上可以在哪些商户使用设备卡支付？
什么是MIPAY？	什么是MIPAY？
什么是小米PAY？	什么是MIPAY？
MIPAY是怎么工作的？	MIPAY是怎么工作的？
小米PAY是怎么工作的？	MIPAY是怎么工作的？
什么是SECUREELEMENT？	什么是SECUREELEMENT？
SECUREELEMENT的含义什么？	什么是SECUREELEMENT？
NFC中的嵌入式安全元件是做什么的？	什么是SECUREELEMENT？
什么手机支持MIPAY？	什么手机支持MIPAY？
什么手机支持小米PAY？	什么手机支持MIPAY？
我的手机是华为手机，支持小米PAY吗？	什么手机支持MIPAY？
哪些手机能用小米PAY？	什么手机支持MIPAY？
什么是云闪付卡？	什么是云闪付卡？
云闪付卡是什么？	什么是云闪付卡？
哪种卡是云闪付卡？	什么是云闪付卡？
云闪付卡是真实的卡片吗？	什么是云闪付卡？
申请MIPAY云闪付卡的时候一直不显示下步信息该怎么办？	申请MIPAY云闪付卡的时候一直不显示下步信息该怎么办？
为什么很久MIPAY云闪付卡申请不出来？	申请MIPAY云闪付卡的时候一直不显示下步信息该怎么办？
MIPAY短信验证码有效期是多长时间？	MIPAY短信验证码有效期是多长时间？
MIPAY短信验证码多久有效？	MIPAY短信验证码有效期是多长时间？
一般隔多久可以重新发送MIPAY短信验证码？	MIPAY短信验证码有效期是多长时间？
几分钟MIPAY短信验证码就无效了？	MIPAY短信验证码有效期是多长时间？
长时间收不到MIPAY短信验证码怎么办？	长时间收不到MIPAY短信验证码怎么办？
为什么我收不到MIPAY短信验证码？	长时间收不到MIPAY短信验证码怎么办？
收不到MIPAY短信验证码怎么办？	长时间收不到MIPAY短信验证码怎么办？
MIPAY云闪付卡显示图片和实际图片不一样会影响使用吗？	MIPAY云闪付卡显示图片和实际图片不一样会影响使用吗？
为什么我的MIPAY云闪付卡图片和你们显示的不一样？	MIPAY云闪付卡显示图片和实际图片不一样会影响使用吗？
你们这个MIPAY的条款和条件是有问题的该怎么办？	你们这个MIPAY的条款和条件是有问题的该怎么办？
我对MIPAY的条款有疑问，该找谁？	你们这个MIPAY的条款和条件是有问题的该怎么办？
在你们这里可以查询MIPAY云闪付卡的卡号吗？	在你们这里可以查询MIPAY云闪付卡的卡号吗？
MIPAY云闪付卡卡号是多少？	在你们这里可以查询MIPAY云闪付卡的卡号吗？
怎么查MIPAY云闪付卡的卡号？	在你们这里可以查询MIPAY云闪付卡的卡号吗？
我在哪里能看到MIPAY云闪付卡的卡号？	在你们这里可以查询MIPAY云闪付卡的卡号吗？
MIPAY云闪付卡只能看到后四位我需要完整的，怎么查？	在你们这里可以查询MIPAY云闪付卡的卡号吗？
我想申请多张MIPAY云闪付卡可以吗？	我想申请多张MIPAY云闪付卡可以吗？
我最多能申请多少张MIPAY云闪付卡？	我想申请多张MIPAY云闪付卡可以吗？
一部小米手机能申请几张MIPAY云闪付卡？	我想申请多张MIPAY云闪付卡可以吗？
一张卡在一部手机上能重复申请云闪付卡吗？	我想申请多张MIPAY云闪付卡可以吗？
有多张MIPAY云闪付卡时，默认使用哪张云闪付卡进行支付？如何设置MIPAY的默认卡？	有多张MIPAY云闪付卡时，默认使用哪张云闪付卡进行支付？如何设置MIPAY的默认卡？
支付的时候我想默认某一张绑定的MIPAY卡付款可以吗？	有多张MIPAY云闪付卡时，默认使用哪张云闪付卡进行支付？如何设置MIPAY的默认卡？
我用MIPAY云闪付卡付款时候不想用这一张想更换的话如何操作？	有多张MIPAY云闪付卡时，默认使用哪张云闪付卡进行支付？如何设置MIPAY的默认卡？
怎么看我银行卡申请了多少张MIPAY云闪付卡？	怎么看我银行卡申请了多少张MIPAY云闪付卡？
卡片丢失了挂失了以后MIPAY云闪付卡需要重新申请吗？	卡片丢失了挂失了以后MIPAY云闪付卡需要重新申请吗？
MIPAY手机坏了怎么办？	MIPAY手机坏了怎么办？
MIPAY云闪付卡能挂失吗？	MIPAY云闪付卡能挂失吗？
怎么挂失MIPAY云闪付卡？	MIPAY云闪付卡能挂失吗？
能解挂MIPAY云闪付卡吗？	MIPAY云闪付卡能挂失吗？
换过手机SIM卡能看到之前的MIPAY云闪付卡吗？	换过手机SIM卡能看到之前的MIPAY云闪付卡吗？
通过云闪付APP我看不到之前的MIPAY云闪付卡了怎么办？	换过手机SIM卡能看到之前的MIPAY云闪付卡吗？
我的小米钱包里面原先绑了好几张MIPAY云闪付卡，突然都没了，是什么情况？	我的小米钱包里面原先绑了好几张MIPAY云闪付卡，突然都没了，是什么情况？
我什么都没动过但是MIPAY的云闪付卡突然不见了，看不到了该怎么办？	我的小米钱包里面原先绑了好几张MIPAY云闪付卡，突然都没了，是什么情况？
在店家怎么用MIPAY付款？	在店家怎么用MIPAY付款？
要怎么使用MIPAY？	在店家怎么用MIPAY付款？
MIPAY需要联网吗？	在店家怎么用MIPAY付款？
MIPAY使用的时候需要提前圈存吗？	MIPAY使用的时候需要提前圈存吗？
MIPAY交易时候要连上网吗？	MIPAY交易时候要连上网吗？
MIPAY交易时需要手机联网吗？	MIPAY交易时候要连上网吗？
如果关机了还能用MIPAY吗？	如果关机了还能用MIPAY吗？
手机关机时候能进行MIPAY的POS交易吗？	如果关机了还能用MIPAY吗？
MIPAY解锁密码无法使用是怎么了？	MIPAY
为什么我的MIPAY指纹锁没有用？	MIPAY
手指滑了半天也无法MIPAY解锁是为什么？	MIPAY
点亮屏幕时候无法使用MIPAY解锁密码是怎么了？	MIPAY
MIPAY的积分和我本身卡片的正常积分一样吗？	MIPAY的积分和我本身卡片的正常积分一样吗？
用MIPAY做交易有积分吗？	MIPAY的积分和我本身卡片的正常积分一样吗？
收到关于MIPAY功能、服务有关的邮件，我有点疑问该如何确认？	收到关于MIPAY功能、服务有关的邮件，我有点疑问该如何确认？
MIPAY的手机ROOT了该怎么办？	MIPAY的手机ROOT了该怎么办？
小米系统更新以后，无法使用MIPAY了该怎么办？	小米系统更新以后，无法使用MIPAY了该怎么办？
我想了解下MIPAY具体的一些技术支持方面的信息能提供吗？	我想了解下MIPAY具体的一些技术支持方面的信息能提供吗？
我的卡绑在MIPAY上安全吗？	我的卡绑在MIPAY上安全吗？
MIPAY到底安不安全？	我的卡绑在MIPAY上安全吗？
我能放心地使用MIPAY吗？	我的卡绑在MIPAY上安全吗？
我使用MIPAY小米那边会有我的数据吗？	我使用MIPAY小米那边会有我的数据吗？
小米作为支持方是否HI保留交易及用卡记录？	我使用MIPAY小米那边会有我的数据吗？
小米那边能看到我的交易信息吗？	我使用MIPAY小米那边会有我的数据吗？
我是招行的卡申请云闪付可以参加银联的MIPAY营销活动吗？	我是招行的卡申请云闪付可以参加银联的MIPAY营销活动吗？
我是招行的卡申请的MIPAY云闪付卡能参加银联的云闪付营销活动吗？	我是招行的卡申请云闪付可以参加银联的MIPAY营销活动吗？
可以在哪些商户使用MIPAY支付？	可以在哪些商户使用MIPAY支付？
可以在哪些商户使用小米PAY支付？	可以在哪些商户使用MIPAY支付？
MIPAY可以在哪里使用？	可以在哪些商户使用MIPAY支付？
我怎么看哪些店可以用MIPAY？	可以在哪些商户使用MIPAY支付？
如何判断这家店可以使用MIPAY?	可以在哪些商户使用MIPAY支付？
什么是APPSTORE？	什么是APPSTORE？
如何在APPLEID上关联银行卡	如何在APPLEID上关联银行卡
怎么在ITUNES中绑卡？	如何在APPLEID上关联银行卡
怎么在APPSTORE中绑卡？	如何在APPLEID上关联银行卡
如何在APPSTORE上使用银联卡完成付款？	如何在APPSTORE上使用银联卡完成付款？
怎么在ITUNES中付款？	如何在APPSTORE上使用银联卡完成付款？
怎么在APPSTORE中付款？	如何在APPSTORE上使用银联卡完成付款？
哪些银行发行的银联卡可以和APPLEID关联账户？	哪些银行发行的银联卡可以和APPLEID关联账户？
APPSTORE支持哪家银行的卡？	哪些银行发行的银联卡可以和APPLEID关联账户？
哪家银行卡可以在APPSTORE中付款？	哪些银行发行的银联卡可以和APPLEID关联账户？
ITUNES银行卡支付限额是多少？	ITUNES银行卡支付限额是多少？
APPSTORE银行卡支付限额是多少？	ITUNES银行卡支付限额是多少？
若需解除或删除APPSTORE账户中已关联的银联卡，如何操作？	若需解除或删除APPSTORE账户中已关联的银联卡，如何操作？
如何删除APPSTORE中的卡片？	若需解除或删除APPSTORE账户中已关联的银联卡，如何操作？
在ITUNES中输入短信验证码后无法点击下一步怎么办？	在ITUNES中输入短信验证码后无法点击下一步怎么办？
APPSTORE输入验证码后无法点击下一步	在ITUNES中输入短信验证码后无法点击下一步怎么办？
为什么ITUNES支付选项中没有银联？	为什么ITUNES支付选项中没有银联？
APPSTORE中没有银联怎么办	为什么ITUNES支付选项中没有银联？
我在APPSTORE中购买的商品没有收到怎么办？	我在APPSTORE中购买的商品没有收到怎么办？
ITUNES交易出现差错了怎么办？	我在APPSTORE中购买的商品没有收到怎么办？
为什么我查到商户名称是BILL.ITUNES.COM?	为什么我查到商户名称是BILL.ITUNES.COM?
我被BILL.ITUNES.COM扣款了	为什么我查到商户名称是BILL.ITUNES.COM?
我被ITUNES扣款了	为什么我查到商户名称是BILL.ITUNES.COM?
如何查询ITUNES的交易？	如何查询ITUNES的交易？
我在ITUNES上买了什么东西？	如何查询ITUNES的交易？
我在APPSTORE里买了什么东西？	如何查询ITUNES的交易？
为什么我的信用卡绑在ITUNES上被扣了<数字>元钱?	为什么我的信用卡绑在ITUNES上被扣了<数字>元钱?
银联卡支付对于系统版本的要求？	银联卡支付对于系统版本的要求？
如果ITUNES在支付中收不到验证码怎么办？	如果ITUNES在支付中收不到验证码怎么办？
ITUNES收不到验证码怎么办？	如果ITUNES在支付中收不到验证码怎么办？
一个APPLEID可以关联几张银行卡？	一个APPLEID可以关联几张银行卡？
一个苹果ID可以关联几张卡？	一个APPLEID可以关联几张银行卡？
一张卡可以关联几个苹果ID？	一个APPLEID可以关联几张银行卡？
如果已关联的银联卡信息发生变化如何处理？	如果已关联的银联卡信息发生变化如何处理？
我在APPSTORE中的卡有效期到了怎么办？	如果已关联的银联卡信息发生变化如何处理？
我在APPSTORE中的卡手机号换了怎么办？	如果已关联的银联卡信息发生变化如何处理？
如果银联卡支付后不满意所购物品怎么办？	如果银联卡支付后不满意所购物品怎么办？
我不喜欢在APPSTORE中买的东西怎么办？	如果银联卡支付后不满意所购物品怎么办？
目前有哪些国家和地区的商户支持银联跨境网上支付业务的服务？	目前有哪些国家和地区的商户支持银联跨境网上支付业务的服务？
国外网站能用银联在线支付吗？	目前有哪些国家和地区的商户支持银联跨境网上支付业务的服务？
如何开通跨境网上在线支付？	如何开通跨境网上在线支付？
怎么在国外网站支付？	如何开通跨境网上在线支付？
跨境网上是否有支付限额？	跨境网上是否有支付限额？
国外网站支付限额是多少？	跨境网上是否有支付限额？
境外网站购买商品需要支付运费和关税吗？	境外网站购买商品需要支付运费和关税吗？
用银联卡进行跨境业务网上支付交易是否需要支付手续费？	用银联卡进行跨境业务网上支付交易是否需要支付手续费？
国外网站买东西需要手续费吗？	用银联卡进行跨境业务网上支付交易是否需要支付手续费？
境内发行银联卡在境外网上购物时使用的交易汇率？	客户咨询境内发行银联卡在境外网上购物时使用的交易汇率？
关于PAYPAL账户的注册及使用问题	关于PAYPAL账户的注册及使用问题
PAYPAL客服电话？	关于PAYPAL账户的注册及使用问题
如何联系PAYPAL	关于PAYPAL账户的注册及使用问题
银联海购平台是个什么平台？	银联海购平台是个什么平台？
银联海购是什么？	银联海购平台是个什么平台？
银联海购如何登陆？	银联海购平台是个什么平台？
为什么建行卡无法在STEAM上进行交易？	为什么建行卡无法在STEAM上进行交易？
为什么STEAM无法安装控件？	为什么STEAM无法安装控件？
我在STEAM中购买的商品没有收到怎么办？	我在STEAM中购买的商品没有收到怎么办？
你们的服务电话	银联的联系电话
我想和真人交流	银联的联系电话
我想跟你通电话	银联的联系电话
可否电话服务？	银联的联系电话
无法联系人工怎么办	为什么客服电话打不通
中国银联作甚麽呢	中国银联概况
我的银行卡在取钱的时候，都是农村信用社，为什么会收手续费	我用A银行的卡片在B银行的ATM机具上取款，要收取多少手续费？
哪个银行跨行取现不收费？	我用A银行的卡片在B银行的ATM机具上取款，要收取多少手续费？
征信中心的服务热线	我需要查询自己的征信情况
您好，请问一下怎么查询自己名下有办理信用卡？	我需要查询自己的征信情况
怎么查银行卡余款	帮我查询一下银行卡余额
我想查一下我的卡上的钱，咋查呢	帮我查询一下银行卡余额
ATM转账多久能到	ATM转账为什么要<数字>小时延迟到账？
转账转错了可以追回吗	ATM转账为什么要<数字>小时延迟到账？
节假日跨行转账<数字>万以内即时到账吗	ATM转账为什么要<数字>小时延迟到账？
我想请问一下那个我钱转别人卡里去了能退回吗	ATM转账为什么要<数字>小时延迟到账？
我绍兴银行/某银行转账到瑞丰/某银行要多久到账	ATM转账为什么要<数字>小时延迟到账？
通过ATM/ATM机跨行划款，一般多久能到账	ATM转账为什么要<数字>小时延迟到账？
去加油站里面有POS机但是不给刷卡怎么投诉	怎么举报套现？
银行卡上有闪付标志的卡交款时都能闪付吗	什么是IC卡闪付？
为什么我付**元不需要签名	什么是小额免密免签？
刷卡为什么不需要密码	什么是小额免密免签？
小额免密免签是否安全	什么是小额免密免签？
请问一下怎样开通闪付免密支付	什么是小额免密免签？
信用卡/借记卡<数字>元以下无密码不签字就可以交易，可以取消吗	如何关闭小额免签免密？
如何解除小额免密功能	如何关闭小额免签免密？
银联可不可以取消小额支付免输密码	如何关闭小额免签免密？
周六和周日都刷卡了都没有到账怎么回事	POS商户入账时间有多长？
你好，我刷的卡怎么沒到账	POS商户入账时间有多长？
你好，请问一下，银联机坏了，该打哪个电话维修	我的POS机具坏了，你们赶紧派人来维修。
我想问一下，为什么POS老是刷卡错误	我的POS机具坏了，你们赶紧派人来维修。
银联有没有POS机	我想安装一台POS机，该找哪里？
你好，店铺安装POSE机/POS机需要什么条件	我想安装一台POS机，该找哪里？
银联有移动POS机吗	我想安装一台POS机，该找哪里？
我想要申请一部银联卡POS机	我想安装一台POS机，该找哪里？
你好，请问有银联POS机吗？	我想安装一台POS机，该找哪里？
你好：我想办一个银联POS机，什么卡都能刷，包括信用卡。	我想安装一台POS机，该找哪里？
请问POS机<数字>一次性分期手续费可以退吗	POS机如何开通分期付款业务？
预授权冻结时间	做了预授权后，资金什么时候返还
怎么我今天的交易记录没有，银行己经扣钱	请帮我查询一笔交易信息
哪里取款的	请帮我查询一笔交易信息
去年的交易可以查吗	请帮我查询一笔交易信息
你好，能帮我查一笔转账记录吗？	请帮我查询一笔交易信息
我想知道我的钱被谁扣了	请帮我查询一笔交易信息
怎么查询信用卡扣款去向	请帮我查询一笔交易信息
请问我的信用卡被人盗用取现了怎么处理？	请帮我查询一笔交易信息
帮我查个交易	请帮我查询一笔交易信息
我想查我以前银行支付，钱的去向	请帮我查询一笔交易信息
我还款后，就没有借了，为什么显示我已借款<数字>元/X元？	请帮我查询一笔交易信息
如何查询跨行交易	请帮我查询一笔交易信息
我想查一下我取钱的信息	请帮我查询一笔交易信息
我这农行的卡，怎么刚才有一笔，银联代收业务？	请帮我查询一笔交易信息
我想查询我昨天支付了X元能帮我查一下吗？	请帮我查询一笔交易信息
麻烦帮我查一下我的卡为什么经常扣我二十五/X块谢谢	请帮我查询一笔交易信息
请问一下在<数字>：<数字>分（某时间点）消费<数字>/X元是什么原因呢	请帮我查询一笔交易信息
我卡上<数字>月<数字>号/某月某日<数字>.<数字>元/X元不翼而飞是怎么回事？	请帮我查询一笔交易信息
请问这笔业务我没办理，钱是如何消费？	请帮我查询一笔交易信息
我想问下今天晚上<数字>点<数字>分（或任意某个时间点）有份支出是消费哪里了	请帮我查询一笔交易信息
今天消费X元是消费什么的?	请帮我查询一笔交易信息
好端端的为什么扣我X元	请帮我查询一笔交易信息
我今天没有消费怎么提示我有消费X元	请帮我查询一笔交易信息
怎么可以查找我使用的交易	请帮我查询一笔交易信息
我银行卡里的X元钱没了	请帮我查询一笔交易信息
查一下我刚才卡上扣的X块钱	请帮我查询一笔交易信息
我有一笔莫名其妙的支出怎么查一下	请帮我查询一笔交易信息
<数字>分/某时间点有一笔X元的支出不知道是怎么回事	请帮我查询一笔交易信息
我收到一笔消费信息，但我又不是我本人消费，怎么就扣除我的钱呢。	请帮我查询一笔交易信息
今天/某天上午/下午<数字>点<数字>分/几点几分收到工商银行/某银行支出银联<数字>/X元，请问这是怎么回事呢？	请帮我查询一笔交易信息
刚刚我卡被交易X元，怎么回事	请帮我查询一笔交易信息
想问一下我这笔扣款是怎么回事？	请帮我查询一笔交易信息
如何查询取钱地点	请帮我查询一笔交易信息
如何查询借记卡的预授权使用地址	请帮我查询一笔交易信息
我想查一笔<数字>**年的交易	我想查一笔<数字>**年的交易
<数字>年/某年交易能查吗	我想查一笔<数字>**年的交易
怎么查MCC	怎么查MCC
MCC码查询	怎么查MCC
你好，查询POS机MCC码？	怎么查MCC
您好，这个商户的MCC类别是什么？	怎么查MCC
商户类型查询	怎么查MCC
MCC查询	怎么查MCC
商户类别码查询	怎么查MCC
我想查询商户类型	怎么查MCC
有小票可以查卡的全号吗	有小票可以查卡的全号吗
你好，ATM跨行转出如何查询对方卡号	有小票可以查卡的全号吗
刷信用卡该收持卡人费用吗	刷信用卡该收持卡人费用吗
请问刷信用卡需要手续费吗	刷信用卡该收持卡人费用吗
建行信用卡消费被收取手续费	刷信用卡该收持卡人费用吗
请问什么是商户代码？	请问什么是商户代码？
商户编号是什么	请问什么是商户代码？
什么是商户编号	请问什么是商户代码？
什么是商户代码	请问什么是商户代码？
怎么办理银行卡	怎么办理银行卡
你好，请问中国银联是中国银行办的卡吗	怎么办理银行卡
中国银联有实体卡吗在什么地方可以办	怎么办理银行卡
密码控件超时	如何安装银联在线支付控件
为什么我支付时银行密码输不进去	如何安装银联在线支付控件
支付密码显示红叉	如何安装银联在线支付控件
你好，为什么我点在线支付的时候不能输入数字？	如何安装银联在线支付控件
安全控件不会弄	如何安装银联在线支付控件
你好，我为什么付款时不能安装安全控件	如何安装银联在线支付控件
为什么我输入银行密码显示不出数字	如何安装银联在线支付控件
交费信用卡背面密码打不进咋回事啊	如何安装银联在线支付控件
网上用信用卡交费背面密码打不进是毛病啊	如何安装银联在线支付控件
不能填密码怎么回事	如何安装银联在线支付控件
填上卡号密码填不进去	如何安装银联在线支付控件
在线支付不能输入后<数字>位	如何安装银联在线支付控件
您好！请问申请银联在线支付账户银行卡验证，填写卡背面末三位数字时要求安装控件不能成功。其原因？纠正？	银联在线支付控件安装不上怎么办
安全控件打不开	银联在线支付控件安装不上怎么办
你好，我控件安装不上，你能帮我看看是怎么回事吗？	银联在线支付控件安装不上怎么办
安装控件，之后刷新，还是安装控件	银联在线支付控件安装不上怎么办
输入银联卡账号后，银行卡密码处，一直显示请点击安装控件，点击按装后，一直显示是点击安装控件，	银联在线支付控件安装不上怎么办
在线支付银行卡密码处，一直是点击安装控件，	银联在线支付控件安装不上怎么办
为什么银联账户验证服务一直需要安装插件已经安装好多遍了	银联在线支付控件安装不上怎么办
控件安装无效	银联在线支付控件安装不上怎么办
你好！我在进行银联账户验证服务，其中银行卡密码栏提示请点击安装控件，但下载完控件不能执行，不知是为	银联在线支付控件安装不上怎么办
输后三位数时，一直让安装插件	银联在线支付控件安装不上怎么办
刚才要付费，需安装控件，但没法安装，怎么办？	银联在线支付控件安装不上怎么办
我下载的银联安全支付助手，为什么总是显示页面失败？	银联在线支付控件安装不上怎么办
我要在亚马逊添加一张光大银行的借记卡，不能添加	为什么支付不成功
我怎么无法付款	为什么支付不成功
为什么用身份证购买的手机卡，又用身份证开的银行卡绑定的手机号码在银联认证就是不正确？	银联支付怎么开不了
为什么充值不了呢？	为什么支付不成功
请问怎么教不了学费呀	为什么支付不成功
怎么还款不了	为什么支付不成功
为啥我的卡不能开通网上银行	为什么支付不成功
HI小U！我在线支付失敗为何？谢！	为什么支付不成功
开通银联总是提示信息不对	为什么支付不成功
网上交易失败	为什么支付不成功
在线开通开通不了	为什么支付不成功
我开通银联，开不起	为什么支付不成功
为什么缴不了费了	为什么支付不成功
为什么开通还是支付不了	为什么支付不成功
我的手机贷绑了我的银行卡，可是还是还不了款	为什么银联在线支付不了
你好，我一直缴不了费	为什么支付不成功
为什么我现在提前还款手机贷，还不了	为什么银联在线支付不了
付款的时候，为啥总提示付款错误	为什么支付不成功
我绑定的储蓄卡里有钱不能还	为什么银联在线支付不了
为什么显示支付未成功	为什么支付不成功
在线付不了	为什么支付不成功
我用银行卡还款怎么还不了	为什么银联在线支付不了
为什么还款还不成功？	为什么支付不成功
请问我想提前还款，为什么一键还款失败，是不支持邮政储蓄银行卡么？	为什么支付不成功
我想还款，可是还不上，老是失败，邮政的卡	为什么支付不成功
绑定银行卡,提示改卡不支持	为什么支付不成功
开通不了银联服务	为什么支付不成功
在线银联支付为什么总是失败	为什么支付不成功
银行卡无法付款	为什么支付不成功
您好，请问为什么总是交易失败	为什么支付不成功
你好，银联在线怎么开通不了了	为什么支付不成功
我银行卡怎么验证不了	为什么支付不成功
你好，我要开通KINDLEUNLIMITED包月服务，为什么一直开通不了？	为什么银联在线支付不了
用信用卡充值为何充不了	为什么支付不成功
一直显示订单超时	为什么银联在线支付不了
我在武商网上面购物信用卡支付时有错误提示	为什么支付不成功
什么绑卡总是失败	银联支付怎么开不了
银行卡不能快捷支付怎么办？	为什么支付不成功
支持的区域性银行（<数字>家）明明写着秦皇岛银行，。为什么添加不了	为什么银联在线支付不了
你好，我通过银联在山东大学研究生信息管理系统上缴纳学费，为什么提示错误？	为什么支付不成功
提交验证失败？	为什么支付不成功
我的怎么是验证失败	为什么支付不成功
你好，请问我已经开通了银联支付，为什么我的建行卡还是不能绑定加油包呢？	为什么支付不成功
已经开通网上银行，但是不能支付，这是什么情况	为什么支付不成功
为什么说我的订单超时缴不了费了该咋办啊	为什么支付不成功
在线支付为什么不行	为什么银联在线支付不了
我想开通网上支付开通不了怎么办	为什么支付不成功
不能付款怎么弄	为什么支付不成功
为什么我提前还款，还不了	为什么银联在线支付不了
点击付款时，总会出现系统错误	为什么支付不成功
网贷还款怎么充值不了	为什么支付不成功
为什么现在无法还款？	为什么支付不成功
你好我的银联卡怎么绑定不了啊	为什么银联在线支付不了
支付出现问题怎么解决	为什么银联在线支付不了
你好我这手机贷款怎么还不了	为什么银联在线支付不了
机票订单支付不了	为什么支付不成功
我这怎么交不了罚款	为什么支付不成功
您的银行卡暂不支持该业务什么意思	为什么银联在线支付不了
为什么总是交易失败	为什么支付不成功
我的怎么支付失败	为什么支付不成功
我还款总是失败什么原因	为什么支付不成功
火车票购票不能付款是怎么回事	为什么支付不成功
绑卡时总是显示信息错误	为什么银联在线支付不了
我们用银联支付，老显示超出商户支付限额，是怎么回事	订单金额超出该商户限额
订单超出商户限额	订单金额超出该商户限额
我想注册商户用户，使用银联接口	如何和银联合作
你好，我想问下银联的对账接口文档有吗	如何和银联合作
你好，我们的APP想开通银联支付方式，请问如何对接呢、	如何和银联合作
如何在APP上植入银联支付端口	如何和银联合作
手机客户端接入银联支付	如何和银联合作
您好！请问企业商户B<数字>B和B<数字>C支付收费标准是什么？	如何和银联合作
如何申请在线支付接口	如何和银联合作
想跟您这边谈下接入支付合作	如何和银联合作
请问银联有代付功能么？	如何和银联合作
我们的APP想开通银联支付方式，请问如何对接呢	如何和银联合作
你好，APP想接银联的支付，怎么接	如何和银联合作
一个平台支付接入云闪付的话手续费多少，要求是什么？	如何和银联合作
银联支付页面可以自己设置语言吗	为什么支付页面显示的不是中文？
可以用荷兰的银行支付吗	目前哪些银行可以用于银联在线支付？
你好，银联卡在线快捷支付支持信用卡吗	目前哪些银行可以用于银联在线支付？
怎么关闭银联手机支付	如何关闭银联在线支付？
关闭银联手机支付	如何关闭银联在线支付？
如何关闭中国银联	如何关闭银联在线支付？
取消开通怎么办	如何关闭银联在线支付？
手机银联在线功能怎么开通？	如何开通银联在线支付？
请问无卡支付怎么办？	如何开通银联在线支付？
怎么开通银联呢？	如何开通银联在线支付？
如何开通银联	如何开通银联在线支付？
在线开通在哪、	如何开通银联在线支付？
银联在线开通	如何开通银联在线支付？
请问怎么开通网上银联	如何开通银联在线支付？
需要在线开通怎么弄	如何开通银联在线支付？
你好网上在线支付怎么弄？	如何开通银联在线支付？
开通在线银联	如何开通银联在线支付？
银行卡开通银联怎么开	如何开通银联在线支付？
银行卡开通快捷服务怎么办开	如何开通银联在线支付？
怎么开通银联认证	如何开通银联在线支付？
银联在线支付功能，是不是先开通银联才能用	如何开通银联在线支付？
你好，认证支付的界面怎么没有了	如何开通银联在线支付？
银联在线支付的开通方式是什么	如何开通银联在线支付？
怎样开通网上支付	如何开通银联在线支付？
请问银联在线认证的网址是什么？	如何开通银联在线支付？
如何添加快捷支付的银行卡	如何开通银联在线支付？
怎么添加快捷支付卡	如何开通银联在线支付？
能直接给我发个链接吗，邮政的，我想开通网上支付功能	邮政储蓄银行
农业银行借记卡限额	银联在线支付的支付限额是什么？
您好工行上限是多少	银联在线支付的支付限额是什么？
交易金额超限	银联在线支付的支付限额是什么？
你好我在网上买东西显示超出限额怎么回事	银联在线支付的支付限额是什么？
支付限额是否可以提升	银联在线支付的支付限额是什么？
支付限额能提高吗	银联在线支付的支付限额是什么？
交易金额超过单次限额	银联在线支付的支付限额是什么？
短信验证码有效期限是多少	短信验证码有效期多久？？
银联支付要手续费吗	进行网上交易是否需要支付手续费？
银联在线的收费标准	进行网上交易是否需要支付手续费？
银联接口接入费用	进行网上交易是否需要支付手续费？
开通在线支付时，取款密码输入超次数怎么办	借记卡密码输错几次后会被锁定？会锁定多久？
为什么要我的银行密码？	银联在线支付如何保证支付交易安全性？
我想知道，如果我通过银联付款某个订单，对方会知道我的详细信息么？	银联在线支付如何保证支付交易安全性？
为什么要填密码	银联在线支付如何保证支付交易安全性？
为什么要输入银行密码	银联在线支付如何保证支付交易安全性？
为什么要输入信用卡背面最后三位数字，这个让人知道后，可以随意扣款了	银联在线支付如何保证支付交易安全性？
短信没有收到	短信验证码接收异常如何处理？
为什么发送验证码发送不了	短信验证码接收异常如何处理？
我在获取银联认证码短信一直发送失败是什么原因？	短信验证码接收异常如何处理？
收不到确认信息怎么办	短信验证码接收异常如何处理？
为啥银行预留的手机号码收不到短信	短信验证码接收异常如何处理？
你好，为什么我点击免费获取收不到短信	短信验证码接收异常如何处理？
我之前预留的手机号不能用了，怎么通过验证	手机号码怎么变更？
我手机号码不用了，收不到验证码，怎么换手机号码	手机号码怎么变更？
怎样更换手机号码	手机号码怎么变更？
我的银联卡换了手机号，现在验证码发不出去怎么办	手机号码怎么变更？
我的手机更改了，可发验证码还是到原来的手机上	手机号码怎么变更？
你好我的网银号码更改了，怎么还是发验证码到以前的手机上呀	手机号码怎么变更？
亲，我想问一下银行预留手机号码变了怎么办	银行预留手机号
为什么银行支付那里我手机号码和银行预留号码不一致？	银行预留手机号
我的换新卡了，然后为什么银联支付的时候还是老卡支付啊	你好，我的信用卡到期换卡了，但是卡号不变，不能付款，如何修改之前信息。
信用卡,旧卡换新卡,卡号不变	你好，我的信用卡到期换卡了，但是卡号不变，不能付款，如何修改之前信息。
如何更改付款的银行卡	你好，我的信用卡到期换卡了，但是卡号不变，不能付款，如何修改之前信息。
已绑定银行卡已作废，如何更换？	你好，我的信用卡到期换卡了，但是卡号不变，不能付款，如何修改之前信息。
更改信用卡信息	你好，我的信用卡到期换卡了，但是卡号不变，不能付款，如何修改之前信息。
开通银联在线支付是不是立即可以使用的	在线支付功能开通多久可以使用
验证失败失败原因：重复交易(<数字>)	验证失败失败原因：重复交易(<数字>)
失败原因：重复交易(<数字>)	验证失败失败原因：重复交易(<数字>)
重复交易(<数字>)	<数字>
失败原因：持卡人身份信息、手机号或CVN<数字>输入不正确，验证失败(<数字>)	失败原因：持卡人身份信息、手机号或CVN<数字>输入不正确，验证失败(<数字>)
持卡人信息或手机号有误	失败原因：持卡人身份信息、手机号或CVN<数字>输入不正确，验证失败(<数字>)
CVN<数字>V输入不正确是什么意思？	失败原因：持卡人身份信息、手机号或CVN<数字>输入不正确，验证失败(<数字>)
在线支付提示银行预留手机号码有误	失败原因：持卡人身份信息、手机号或CVN<数字>输入不正确，验证失败(<数字>)
我的信息是正确的为什么显示持卡人信息错误	失败原因：持卡人身份信息、手机号或CVN<数字>输入不正确，验证失败(<数字>)
显示持卡人信息错误	失败原因：持卡人身份信息、手机号或CVN<数字>输入不正确，验证失败(<数字>)
我在查询我的个人信用信息，但是老是说我银联的提交信息不正确，说身份信息或手机号码，CNV<数字>码不正确，	失败原因：持卡人身份信息、手机号或CVN<数字>输入不正确，验证失败(<数字>)
持卡人身份信息，手机号或CVN<数字>错误	失败原因：持卡人身份信息、手机号或CVN<数字>输入不正确，验证失败(<数字>)
提示持卡人身份信息，手机号或CVN<数字>错误	失败原因：持卡人身份信息、手机号或CVN<数字>输入不正确，验证失败(<数字>)
输入的密码、有效期或CVN<数字>有误	失败原因：持卡人身份信息、手机号或CVN<数字>输入不正确，验证失败(<数字>)
有效期或CVN<数字>有误	失败原因：持卡人身份信息、手机号或CVN<数字>输入不正确，验证失败(<数字>)
请问。你好，我输入了号码后，出现了报文格式错误（<数字>）什么意思？谢谢	请问。你好，我输入了号码后，出现了报文格式错误（<数字>）什么意思？谢谢
你好报文格式错误是什么意思	请问。你好，我输入了号码后，出现了报文格式错误（<数字>）什么意思？谢谢
提示报文错误是怎么了？	请问。你好，我输入了号码后，出现了报文格式错误（<数字>）什么意思？谢谢
<数字>，显示格式错误是怎么回事	请问。你好，我输入了号码后，出现了报文格式错误（<数字>）什么意思？谢谢
报文格式错误(<数字>)	请问。你好，我输入了号码后，出现了报文格式错误（<数字>）什么意思？谢谢
报文格式错误(<数字>)CERTIFID无效	请问。你好，我输入了号码后，出现了报文格式错误（<数字>）什么意思？谢谢
我怎么存不了款啊？提示报文错误怎么回事？	请问。你好，我输入了号码后，出现了报文格式错误（<数字>）什么意思？谢谢
支付提示无此交易权限(<数字>)	<数字>
交易失败。详情请咨询<数字>(<数字>)	交易失败。详情请咨询<数字>(<数字>)
我这个边总是报<数字>	<数字>
我买改签火车票付款<数字>次，这里付款成功，但都没改签成功	我买改签火车票付款<数字>次，这里付款成功，但都没改签成功
我在网上付款之后，银行卡已经扣款，但是对方没有收到，怎么办？	我买改签火车票付款<数字>次，这里付款成功，但都没改签成功
为什么我用信用卡冲的点卡都一天了还不到帐呢	我买改签火车票付款<数字>次，这里付款成功，但都没改签成功
你好。我在网上交了学费，但是系统显示没有扣费成功。	我买改签火车票付款<数字>次，这里付款成功，但都没改签成功
支付扣款，订单没到	我买改签火车票付款<数字>次，这里付款成功，但都没改签成功
请问我交罚款钱交了但是没有处理成功	我买改签火车票付款<数字>次，这里付款成功，但都没改签成功
你好，我在江苏地税网上平台交纳税金，现在查不到你们订单，怎么办	我买改签火车票付款<数字>次，这里付款成功，但都没改签成功
未支付成功但是又扣费了	我买改签火车票付款<数字>次，这里付款成功，但都没改签成功
我要一笔交易订单号	我买改签火车票付款<数字>次，这里付款成功，但都没改签成功
我刚才在辽宁城市建设学校报名交费怎么看报名成没成功我这面已经扣钱了	我买改签火车票付款<数字>次，这里付款成功，但都没改签成功
为什么网上支付已扣钱，没有成功缴费	我买改签火车票付款<数字>次，这里付款成功，但都没改签成功
交费了为何显示未交费	我买改签火车票付款<数字>次，这里付款成功，但都没改签成功
为什么交易待支付钱扣了	我买改签火车票付款<数字>次，这里付款成功，但都没改签成功
我刚才银联无卡支付没到账	我买改签火车票付款<数字>次，这里付款成功，但都没改签成功
我刚刚支付成功，可是查询为什么不显示呢	我买改签火车票付款<数字>次，这里付款成功，但都没改签成功
我在网上支付缴费，缴费成功了，还是显示未交费	我买改签火车票付款<数字>次，这里付款成功，但都没改签成功
你好，我在网银上面交违章罚款，银行卡钱扣了，但是违章显示没有交款，能查询吗	我买改签火车票付款<数字>次，这里付款成功，但都没改签成功
我昨天用银联充值了<数字>元还没到账	我买改签火车票付款<数字>次，这里付款成功，但都没改签成功
你好！我昨天晚上通过银联汇<数字>快钱，到我的三方平台，账户，银行扣了钱，怎么我账户里没有到账	我买改签火车票付款<数字>次，这里付款成功，但都没改签成功
请问交易关闭是什么意思？我银行扣款了	我买改签火车票付款<数字>次，这里付款成功，但都没改签成功
我的农业银行卡在<数字>年<数字>月<数字>日被转走<数字>元，卡在我身上，别人如何能转钱	我买改签火车票付款<数字>次，这里付款成功，但都没改签成功
想问下，我刚才银联在线支付成功，但对方没收到，怎么办	我买改签火车票付款<数字>次，这里付款成功，但都没改签成功
付款成功了，卡里钱已经出去了，但对方没有收到款，这是什么情况呢？	我买改签火车票付款<数字>次，这里付款成功，但都没改签成功
你好，我已经扣款成功，可是订单没有成功	我买改签火车票付款<数字>次，这里付款成功，但都没改签成功
银行来信息，显示我已付款，为什么还有在线支付的界面	我买改签火车票付款<数字>次，这里付款成功，但都没改签成功
我已经支付了银行卡扣钱短信也来了但是交易没有完成我查不到订单它显示图片码填写错误	我买改签火车票付款<数字>次，这里付款成功，但都没改签成功
我交了费，怎么显示还没有交过	我买改签火车票付款<数字>次，这里付款成功，但都没改签成功
你好，已付款成功，为何显示订单还是未支付？	我买改签火车票付款<数字>次，这里付款成功，但都没改签成功
为什么查不到付款信息	我买改签火车票付款<数字>次，这里付款成功，但都没改签成功
我在携程网上退票，显示退款显示到账，但我查询我的账户并未到账	我买改签火车票付款<数字>次，这里付款成功，但都没改签成功
教师证考试为什么不能用银联卡支付呢？	教师证考试为什么不能用银联卡支付呢？
你好！在支付遇到问题解答中您可以点击网银支付左边的“银联卡支付”，我没找到银联卡支付？	教师证考试为什么不能用银联卡支付呢？
上面显示可以使用重庆银行的卡，但是卡号输入后显示不支持	教师证考试为什么不能用银联卡支付呢？
银联网上支付可以缴纳交通罚款吗？	教师证考试为什么不能用银联卡支付呢？
订单有效期是多久	订单有效期是多久
订单中发现错误信息怎样修改	订单有效期是多久
你好，订单付款以后如何退款？	订单有效期是多久
网银退款到账时间	网银退款到账时间
网银交易怎么查	网银退款到账时间
多次收到你们的短信	多次收到你们的短信
多次受到短信	多次收到你们的短信
无故收到短信验证码	多次收到你们的短信
莫名其妙收到短信验证码	多次收到你们的短信
收到银联短信是为什么？	多次收到你们的短信
请问银联测试帐号在哪里查	请问银联测试帐号在哪里查
测试支付扣钱吗	请问银联测试帐号在哪里查
考试缴费时，显示：<数字>，商户无可用支付方式	考试缴费时，显示：<数字>，商户无可用支付方式
你好,使用银联支付报错，提示“OH...出错了，再试试？[<数字>]”	<数字>
<数字>是什么错误	<数字>
在线支付的交易申请退款了，但是之前的银行卡号注销了	在线支付的交易申请退款了，但是之前的银行卡号注销了
可以打客服电话开通吗？	可以打客服电话开通吗？
交易风险限制	交易风险限制
你们担保支持哪些信用卡	你们担保支持哪些信用卡
我问一下用手机浏览器能不能开通在线支付	我问一下用手机浏览器能不能开通在线支付
安全证书过期了，怎么重新下载安装	安全证书过期了，怎么重新下载安装
美国能用银联吗	银行卡能否在境外使用
银联信用卡能否支付美金	银行卡能否在境外使用
请问银联借记卡在美国地区可以取出当地货币吗？	银行卡能否在境外使用
银联卡在美国可以使用吗？	银行卡能否在境外使用
境外使用汇率	如何查询汇率
今天汇率是多少	如何查询汇率
汇率是多少？	如何查询汇率
您好，想咨询不同银行的银联卡在美国ATM机上都是一样的汇率吗	如何查询汇率
跨境取款限额	境外ATM取现是否有次数限制和金额限制？
境外ATM取现显示金额超限	境外ATM取现是否有次数限制和金额限制？
为什么我在国外取款提示我金额超限了	境外ATM取现是否有次数限制和金额限制？
境内银联卡到境外柜员机提现，限额是多少？	境外ATM取现是否有次数限制和金额限制？
在国外银联的日取额度是多少	境外ATM取现是否有次数限制和金额限制？
我在中国银行办个信用卡，到美国取现如何收费	境外使用银联卡的手续费为多少？
请问境外手续费是多少美国	境外使用银联卡的手续费为多少？
美国ATM手续费	境外使用银联卡的手续费为多少？
我想咨询一下建行借记卡境外刷卡消费要手续费吗？	境外使用银联卡的手续费为多少？
境外取现服务费有吗	境外使用银联卡的手续费为多少？
建设银行的储蓄卡在美国取钱的费用是多少	境外使用银联卡的手续费为多少？
请问在海外使用银联卡，刷卡会有手续费吗？	境外使用银联卡的手续费为多少？
哪个银行的卡在境外取款手续费低？	境外使用银联卡的手续费为多少？
银联国际官网	银联国际官网
为什么我查询不到退税的进度	境外退税资金迟迟未到账
APPSTORE是干嘛的？	什么是APPSTORE？
APPSTORE是做什么的？	什么是APPSTORE？
银联卡如何在ITUNES中使用？	如何在APPSTORE上使用银联卡完成付款？
银联卡如何在APPSTORE中使用？	如何在APPSTORE上使用银联卡完成付款？
我的卡是中国银行的，可以在APPSTORE中绑定吗？	哪些银行发行的银联卡可以和APPLEID关联账户？
APPSTORE支持中国银行付款吗？	哪些银行发行的银联卡可以和APPLEID关联账户？
银行卡在APPSTORE中最多能支付多少钱？	ITUNES银行卡支付限额是多少？
怎样解除与APPLESTORE的银行卡绑定	若需解除或删除APPSTORE账户中已关联的银联卡，如何操作？
怎么取消银联卡在ITUNES的绑定	若需解除或删除APPSTORE账户中已关联的银联卡，如何操作？
APPSTORE输入验证码点击下一步没反应怎么办？	在ITUNES中输入短信验证码后无法点击下一步怎么办？
APPSTORE里找不到银联支付怎么办？	为什么ITUNES支付选项中没有银联？
ITUNES中买了东西没收到怎么办？	我在APPSTORE中购买的商品没有收到怎么办？
为什么ITUNES扣了我的钱	为什么我查到商户名称是BILL.ITUNES.COM?
为什么用信用卡在绑定苹果ID时被扣款<数字>元钱？	为什么我的信用卡绑在ITUNES上被扣了<数字>元钱?
银联支付支持的IOS最低版本？	银联卡支付对于系统版本的要求？
APPSTORE收不到验证码怎么办？？	如果ITUNES在支付中收不到验证码怎么办？
一张卡可以关联几个ITUNES账户？	一个APPLEID可以关联几张银行卡？
我在APPSTORE中的银行卡信息更变了怎么办？	如果已关联的银联卡信息发生变化如何处理？
我不喜欢在ITUNES中买的东西怎么办？	如果银联卡支付后不满意所购物品怎么办？
PAYPAL支付限额	跨境网上是否有支付限额？
境外网站支付限额是多少？	跨境网上是否有支付限额？
如何查询国外网站支付限额？	跨境网上是否有支付限额？
如何查询境外网站支付限额？	跨境网上是否有支付限额？
境外网站买东西需要手续费吗？	用银联卡进行跨境业务网上支付交易是否需要支付手续费？
如何查询境外网站使用的汇率？	如何查询汇率
STEAM中出现交易差错了怎么办？	我在STEAM中购买的商品没有收到怎么办？
香港银联客服电话	香港银联客服电话
我在香港如何联系银联	香港银联客服电话
我在澳门如何联系银联	澳门银联客服电话
澳门银联客服电话	澳门银联客服电话
我在台湾如何联系银联	台湾银联客服电话
台湾银联客服电话	台湾银联客服电话
我在日本如何联系银联	日本银联客服电话
日本银联客服电话	日本银联客服电话
我在韩国如何联系银联	韩国银联客服电话
韩国银联客服电话	韩国银联客服电话
我在新加坡如何联系银联	新加坡银联客服电话
新加坡银联客服电话	新加坡银联客服电话
我在马来西亚如何联系银联	马来西亚银联客服电话
马来西亚银联客服电话	马来西亚银联客服电话
我在泰国如何联系银联	泰国银联客服电话
泰国银联客服电话	泰国银联客服电话
我在越南如何联系银联	越南银联客服电话
越南银联客服电话	越南银联客服电话
我在菲律宾如何联系银联	菲律宾银联客服电话
菲律宾银联客服电话	菲律宾银联客服电话
我在印尼如何联系银联	印尼银联客服电话
印尼银联客服电话	印尼银联客服电话
我在文莱如何联系银联	文莱银联客服电话
文莱银联客服电话	文莱银联客服电话
我在阿联酋如何联系银联	阿联酋银联客服电话
阿联酋银联客服电话	阿联酋银联客服电话
我在澳大利亚如何联系银联	澳大利亚银联客服电话
澳大利亚银联客服电话	澳大利亚银联客服电话
我在新西兰如何联系银联	新西兰银联客服电话
新西兰银联客服电话	新西兰银联客服电话
我在美国如何联系银联	美国银联客服电话
美国银联客服电话	美国银联客服电话
我在加拿大如何联系银联	加拿大银联客服电话
加拿大银联客服电话	加拿大银联客服电话
我在巴西如何联系银联	巴西银联客服电话
巴西银联客服电话	巴西银联客服电话
我在阿根廷如何联系银联	阿根廷银联客服电话
阿根廷银联客服电话	阿根廷银联客服电话
我在秘鲁如何联系银联	秘鲁银联客服电话
秘鲁银联客服电话	秘鲁银联客服电话
我在哥伦比亚如何联系银联	哥伦比亚银联客服电话
哥伦比亚银联客服电话	哥伦比亚银联客服电话
我在英国如何联系银联	英国银联客服电话
英国银联客服电话	英国银联客服电话
我在法国如何联系银联	法国银联客服电话
法国银联客服电话	法国银联客服电话
我在德国如何联系银联	德国银联客服电话
德国银联客服电话	德国银联客服电话
我在意大利如何联系银联	意大利银联客服电话
意大利银联客服电话	意大利银联客服电话
我在瑞士如何联系银联	瑞士银联客服电话
瑞士银联客服电话	瑞士银联客服电话
我在西班牙如何联系银联	西班牙银联客服电话
西班牙银联客服电话	西班牙银联客服电话
我在奥地利如何联系银联	奥地利银联客服电话
奥地利银联客服电话	奥地利银联客服电话
我在葡萄牙如何联系银联	葡萄牙银联客服电话
葡萄牙银联客服电话	葡萄牙银联客服电话
我在丹麦如何联系银联	丹麦银联客服电话
丹麦银联客服电话	丹麦银联客服电话
我在瑞典如何联系银联	瑞典银联客服电话
瑞典银联客服电话	瑞典银联客服电话
我在挪威如何联系银联	挪威银联客服电话
挪威银联客服电话	挪威银联客服电话
我在匈牙利如何联系银联	匈牙利银联客服电话
匈牙利银联客服电话	匈牙利银联客服电话
我在波兰如何联系银联	波兰银联客服电话
波兰银联客服电话	波兰银联客服电话
我在冰岛如何联系银联	冰岛银联客服电话
冰岛银联客服电话	冰岛银联客服电话
我在爱尔兰如何联系银联	爱尔兰银联客服电话
爱尔兰银联客服电话	爱尔兰银联客服电话
我在比利时如何联系银联	比利时银联客服电话
比利时银联客服电话	比利时银联客服电话
我在卢森堡如何联系银联	卢森堡银联客服电话
卢森堡银联客服电话	卢森堡银联客服电话
我在捷克如何联系银联	捷克银联客服电话
捷克银联客服电话	捷克银联客服电话
我在斯洛伐克如何联系银联	斯洛伐克银联客服电话
斯洛伐克银联客服电话	斯洛伐克银联客服电话
我在土耳其如何联系银联	土耳其银联客服电话
土耳其银联客服电话	土耳其银联客服电话
我在希腊如何联系银联	希腊银联客服电话
希腊银联客服电话	希腊银联客服电话
我在俄罗斯如何联系银联	俄罗斯银联客服电话
俄罗斯银联客服电话	俄罗斯银联客服电话
我在南非如何联系银联	南非银联客服电话
南非银联客服电话	南非银联客服电话
我在毛里求斯如何联系银联	毛里求斯银联客服电话
毛里求斯银联客服电话	毛里求斯银联客服电话
我在埃及如何联系银联	埃及银联客服电话
埃及银联客服电话	埃及银联客服电话
一张银行卡最多能申请几张云卡	一张银行卡可以申请几张设备卡（云闪付卡）？
我想知道云卡卡号怎么查	如何查询云闪付卡卡号？
云卡卡号能查吗	如何查询云闪付卡卡号？
华为PAY可以绑定多少卡啊	一张银行卡可以有几张HUAWEIPAY云闪付卡
手机必须联网才用云闪付能交易吗	SAMSUNGPAY交易时手机需要联网吗？
为什么我的三星手机解锁密码不能用了	SAMSUNGPAY指纹验证或解锁密码验证不起作用
为什么我的三星手机指纹验证不能用了	SAMSUNGPAY指纹验证或解锁密码验证不起作用
为什么我的小米手机解锁密码不能用了	MIPAY
为什么我的小米手机指纹验证不能用了	MIPAY
二维码怎么支付	怎么使用扫码支付？
银联二维码支付产品是什么？	银联二维码支付产品是什么？
银联二维码支付的定义是什么？	银联二维码支付产品是什么？
什么是银联二维码支付？	银联二维码支付产品是什么？
银联二维码支付产品包含哪些类型？	银联二维码支付产品包含哪些类型？
银联二维码支付有哪些业务场景？	银联二维码支付产品包含哪些类型？
什么是主扫消费？	什么是主扫消费？
怎样实现主扫消费？	什么是主扫消费？
什么是被扫消费？	什么是被扫消费？
怎样实现被扫消费？	什么是被扫消费？
什么是人到人付款？	什么是人到人付款？
怎样实现人到人付款？	什么是人到人付款？
什么是二维码取现？	什么是二维码取现？
二维码取现的定义是什么？	什么是二维码取现？
哪些APP具备被扫消费功能？	哪些APP具备被扫消费功能？
目前哪些客户端支持银联二维码支付？	哪些APP具备被扫消费功能？
哪些商户可以使用被扫消费支付？	哪些商户可以使用被扫消费支付？
目前哪些商户支持银联二维码支付？	哪些商户可以使用被扫消费支付？
如何区分银联二维码支付与其他渠道（银行/微信）二维码支付？	如何区分银联二维码支付与其他渠道银行微信二维码支付？
怎样判断银行的的二维码支付和银联二维码支付？	如何区分银联二维码支付与其他渠道银行微信二维码支付？
银行客户端的二维码支付是否需要输入密码？	银行客户端的二维码支付是否需要输入密码？
为什么使用银行客户端的银联二维码支付不需要输入密码？	银行客户端的二维码支付是否需要输入密码？
白金卡生成的二维码是使用原卡的权益及银行积分吗？	白金卡生成的二维码是使用原卡的权益及银行积分吗？
银联二维码支付能使用白金卡的权益吗？	白金卡生成的二维码是使用原卡的权益及银行积分吗？
银联二维码有效期多久？	银联二维码有效期多久？
银联二维码支付每次更新支付码号的时间？	银联二维码有效期多久？
银联账号必须手机号码吗	如何注册银联持卡人服务网站用户名？
请问银联钱包能用邮箱注册吗？	如何注册银联持卡人服务网站用户名？
注销用户名	如何注销注册用户名？
帮我注销用户名吧	如何注销注册用户名？
我想了解下咱们银联账户可以销号吗	如何注销注册用户名？
登陆老是显示密码错误？	如何寻回登录密码？
密码正确怎么登录不上	如何寻回登录密码？
忘记登录名	如何修改登录密码？
登入密码忘记了	如何修改登录密码？
你好，请问密码忘记了	如何修改登录密码？
怎么能把认证的号码取消啊	银联账户已关联身份信息可以修改吗？
请问怎样更改实名认证的身份信息？	银联账户已关联身份信息可以修改吗？
我想更改身份信息	银联账户已关联身份信息可以修改吗？
实名认证可以注销吗	银联账户已关联身份信息可以修改吗？
怎么无法修改身份证号码	银联账户已关联身份信息可以修改吗？
你好，如何解绑身份证	银联账户已关联身份信息可以修改吗？
怎样修改个人信息	银联账户已关联身份信息可以修改吗？
持有回乡证用户如何通过银联钱包身份认证？	银联账户支持哪些证件进行实名认证呢？
能查到转账的对方帐号吗	能查到转账的对方帐号吗
银行卡种查询	银行卡种查询
用自助取款机跨行转账后，打客服电话停止转账后，多长时间后，钱返回原来的账户	用自助取款机跨行转账后，打客服电话停止转账后，多长时间后，钱返回原来的账户
信用卡闪付需要圈存吗	信用卡闪付需要圈存吗
POS机出现应答码<数字>是什么意思？	POS机出现应答码<数字>是什么意思？
怎么重置信用卡的查询密码	怎么重置信用卡的查询密码
工商卡异地存款要手续费吗？	工商卡异地存款要手续费吗？
你们和银行什么关系	你们和银行什么关系
怎么把电子现金里的钱提出来	怎么把电子现金里的钱提出来
预授权为何会多收<数字>%	预授权为何会多收<数字>%
预授权多冻结了	预授权为何会多收<数字>%
短信验证码的有效期是多久？	短信验证码有效期多久？？
红包交易出现差错怎么办？	红包交易出现差错怎么办？
交易失败红包被扣了怎么办？	红包交易出现差错怎么办？
交易失败后红包什么时候返还？	红包交易出现差错怎么办？
暂时无法判定该卡是您本人请开通银联支付或换张银行卡是什么意思/情况？	暂时无法判定该卡是您本人请开通银联支付或换张银行卡
为什么会提示暂时无法判定该卡是您本人请开通银联支付或换张银行卡	暂时无法判定该卡是您本人请开通银联支付或换张银行卡
为什么钱包APP绑卡提示“暂时无法判定该卡是您本人请开通银联支付或换张银行卡”	暂时无法判定该卡是您本人请开通银联支付或换张银行卡
银联认证码怎么获取	银联认证码怎么获取
银联验证码怎么弄	银联认证码怎么获取
如何获取银联验证码？	银联认证码怎么获取
征信中如何验证银行卡？	征信中如何验证银行卡？
征信中的银行卡验证需要哪些信息？	征信中如何验证银行卡？
征信支持哪些银行卡验证？	征信支持哪些银行卡验证？
招商银行借记卡为什么不能做征信？	征信支持哪些银行卡验证？
什么银行的卡可以做征信？	征信支持哪些银行卡验证？
点击“获取银联认证码”按钮后出现空白页面怎么办？	点击“获取银联认证码”按钮后出现空白页面怎么办？
做征信时点击获取认证码后空白了怎么办？	点击“获取银联认证码”按钮后出现空白页面怎么办？
查询征信验证时报错“姓名、证件类型、证件号不匹配”是怎么回事	查询征信验证时报错“姓名、证件类型、证件号不匹配”是怎么回事
姓名、证件类型、证件号不匹配是什么意思？	查询征信验证时报错“姓名、证件类型、证件号不匹配”是怎么回事
获取银联认证码有次数限制吗？	获取银联认证码有次数限制吗？
可以获取多少次银联认证码？	获取银联认证码有次数限制吗？
为什么做征信时报错：“您输入的姓名、身份证号与在征信中心上注册时填写的信息不一致，请重新输入	为什么做征信时报错：“您输入的姓名、身份证号与在征信中心上注册时填写的信息不一致，请重新输入
您输入的姓名、身份证号与在征信中心上注册时填写的信息不一致，请重新输入是怎么回事？	为什么做征信时报错：“您输入的姓名、身份证号与在征信中心上注册时填写的信息不一致，请重新输入
征信中提示超过姓名栏位的字数限制是怎么回事？	征信中提示超过姓名栏位的字数限制是怎么回事？
为什么征信中提示超过姓名栏位的字数限制？	征信中提示超过姓名栏位的字数限制是怎么回事？
做征信时提示超过姓名栏位的字数限制是怎么回事？	征信中提示超过姓名栏位的字数限制是怎么回事？
生活缴费需要支付手续费吗？	生活缴费需要支付手续费吗？
交电费/水费/煤气费需要手续费吗？	生活缴费需要支付手续费吗？
生活缴费要交多少手续费？	生活缴费需要支付手续费吗？
交水电煤有手续费吗？	生活缴费需要支付手续费吗？
生活缴费能否提供发票？	生活缴费能否提供发票？
我想要生活缴费的发票。	生活缴费能否提供发票？
可以打印水电煤缴费的发票吗？	生活缴费能否提供发票？
生活缴费是否可帮别人代缴？	生活缴费是否可帮别人代缴？
我可以帮别人交水电煤吗	生活缴费是否可帮别人代缴？
我可以帮别人交电费/水费/煤气费吗	生活缴费是否可帮别人代缴？
生活缴费如何找到缴费户号？	生活缴费如何找到缴费户号？
电费/水费/煤气费的户号在哪里查看？	生活缴费如何找到缴费户号？
水电煤的户号在哪里可以看到？	生活缴费如何找到缴费户号？
在哪里可以找到生活缴费的户号？	生活缴费如何找到缴费户号？
在哪里可以看电费/水费/煤气费的户号？	生活缴费如何找到缴费户号？
哪些地区可以缴纳交通罚款？	哪些地区可以缴纳交通罚款？
我在XX城市可以交违章吗？	哪些地区可以缴纳交通罚款？
我在上海可以交违章吗？	哪些地区可以缴纳交通罚款？
我在哈尔滨可以交违章吗？	哪些地区可以缴纳交通罚款？
违章代办支持哪些城市？	哪些地区可以缴纳交通罚款？
我可以缴纳哪些城市的交通罚款？	哪些地区可以缴纳交通罚款？
被扣分的罚单可以缴纳吗？	被扣分的罚单可以缴纳吗？
被扣分的违章可以交吗？	被扣分的罚单可以缴纳吗？
我的违章被扣了X分可以交吗？	被扣分的罚单可以缴纳吗？
缴纳违章收取手续费吗？	缴纳违章收取手续费吗？
交车辆罚款有手续费吗？	缴纳违章收取手续费吗？
缴纳交通罚款需要支付手续费吗	缴纳违章收取手续费吗？
异地违章，是否可以代办缴费？	异地违章，是否可以代办缴费？
我在其他城市违章了可以交吗？	异地违章，是否可以代办缴费？
话费宽带缴费收取手续费吗？	话费宽带缴费收取手续费吗？
交宽带需要交手续费吗？	话费宽带缴费收取手续费吗？
交话费需要交手续费吗？	话费宽带缴费收取手续费吗？
如何缴纳电费/水费/煤气费？持卡人服务网站	持卡人服务网站
哪些城市可以缴纳（交）电费/水费/煤气费？持卡人服务网站	持卡人服务网站
生活缴费有上限吗？持卡人服务网站	持卡人服务网站
为什么缴费成功了，电费/水费/煤气费没销账？持卡人服务网站	持卡人服务网站
逾期的电费/水费/煤气费账单可以交吗？持卡人服务网站	持卡人服务网站
怎么删除电费/水费/煤气费账号？持卡人服务网站	持卡人服务网站
在哪里可以看到之前的生活缴费记录？持卡人服务网站	持卡人服务网站
违章罚款怎么交持卡人服务网站	持卡人服务网站
还款时，借记卡在银行开户的姓名和信用卡必需一致吗？	还款时，借记卡在银行开户的姓名和信用卡必需一致吗？
我可以给别人的信用卡还款吗？	还款时，借记卡在银行开户的姓名和信用卡必需一致吗？
我想还信用卡，持卡人服务网站	持卡人服务网站
还信用卡有手续费吗？持卡人服务网站	持卡人服务网站
哪些银行支持信用卡还款？持卡人服务网站	持卡人服务网站
ATM汇款能查询多久的	请帮我查询一下该笔交易的具体时间。
微信交易查询可查询时限	请帮我查询一下该笔交易的具体时间。
本来有<数字>多元，现在只有<数字>多了，为什么？？	请帮我查询一下该笔交易的具体时间。
昨天晚上一笔扣款<数字>	请帮我查询一下该笔交易的具体时间。
我这笔扣款是不是有问题？	请帮我查询一下该笔交易的具体时间。
昨天中午<数字>点左右<数字>多的一笔出账什么	请帮我查询一下该笔交易的具体时间。
我问一下今天我的工商银行卡里<数字>多没有了，显示转账	请帮我查询一下该笔交易的具体时间。
我想你帮我查一下。我票退了钱没退过来	请帮我查询一下该笔交易的具体时间。
今天我多扣了一次款	请帮我查询一下该笔交易的具体时间。
帮我查下，今天是那个小额贷款平台通过你们这个平台扣除我的钱	请帮我查询一下该笔交易的具体时间。
今天扣的<数字>块是什么意思？	请帮我查询一下该笔交易的具体时间。
我<数字>.<数字>刷的信用卡，现在还在你们银联扣着	请帮我查询一下该笔交易的具体时间。
给我查一下这两笔钱是一家公司扣款吗？	请帮我查询一下该笔交易的具体时间。
为什么无缘无故扣钱	请帮我查询一下该笔交易的具体时间。
今天怎么扣我<数字>	请帮我查询一下该笔交易的具体时间。
你好，麻烦你给我查一下今天上午从我工商银行尾号<数字>扣的<数字>元钱是什么费用	请帮我查询一下该笔交易的具体时间。
我的工商银行卡显示被中国银联股份有限公司广东分公司扣除易联支出<数字>元，什么意思	请帮我查询一下该笔交易的具体时间。
你好我卡为什么扣除<数字>块钱	请帮我查询一下该笔交易的具体时间。
我想查下我卡昨天有笔<数字>.<数字>的扣费是怎么回事	请帮我查询一下该笔交易的具体时间。
<数字>分扣了<数字>块钱，我什么都没买怎么回事？	请帮我查询一笔交易信息
我想问一下我下午<数字>.<数字>分有一笔<数字>的资金去向	请帮我查询一下该笔交易的具体时间。
今天上午<数字>点被你们扣了一笔钱，<数字>.<数字>	请帮我查询一下该笔交易的具体时间。
银联代收怎么回事	请帮我查询一下该笔交易的具体时间。
我的银行卡怎么消费的	请帮我查询一下该笔交易的具体时间。
今天早上完成消费人民币<数字>.<数字>	请帮我查询一下该笔交易的具体时间。
可以在你们那看到那个平台扣费情况吗？	POS交易能查询商户名称吗？
为什么上海银联分公司从我卡里扣走<数字>.<数字>块	请帮我查询一下该笔交易的具体时间。
我想查一下今天下午的刷卡记录	请帮我查询一笔交易信息
我想查询下信用卡刷了多少钱？	POS交易能查询商户名称吗？
好的，我有一个扣款不清楚想咨询一下	POS交易能查询商户名称吗？
今天我的卡上突然发来扣除<数字>元，不知道是哪个业务呢？	POS交易能查询商户名称吗？
你好，我想问今天在商场消费了里，钱扣了，商场没收到	POS交易能查询商户名称吗？
<数字>经银联网络进行网上交易人民币<数字>.<数字>元。[招商银行]	POS交易能查询商户名称吗？
这笔钱没有消费过，怎么会这样显示？	POS交易能查询商户名称吗？
为什么我今天消费了，却显示没有消费，还要消费一笔，怎么回事	POS交易能查询商户名称吗？
能不能帮我查下<数字>月<数字>号的交易商家	POS交易能查询商户名称吗？
你好请帮我查一下，我今天支出金额怎么多了一笔<数字>.<数字>	POS交易能查询商户名称吗？
麻烦你帮我看看<数字>月<数字>，扣<数字>块钱是什么事情扣的	POS交易能查询商户名称吗？
我的卡上都消费了什么	POS交易能查询商户名称吗？
代收的什么款？？？	POS交易能查询商户名称吗？
刚刚我的卡扣了四千多（或任意数字）是什么意思	请帮我查询一笔交易信息
麻烦帮我查一下哪家公司在我银行卡上代收X元	请帮我查询一笔交易信息
请问这个扣款是什么费用呀	请帮我查询一笔交易信息
请问我要查询交易怎么查询	请帮我查询一笔交易信息
如何查扣款	POS交易能查询商户名称吗？
交易查询的方式	请帮我查询一笔交易信息
为什么我自动扣费了	请帮我查询一笔交易信息
我卡上扣的是什么钱	请帮我查询一笔交易信息
今天早上我的工行卡有一个<数字>元的支出打工行客服问客服说是银联扣的	请帮我查询一笔交易信息
我卡里的钱莫名其妙少了	请帮我查询一笔交易信息
麻烦帮我查一下这笔钱属于哪里转走了？	请帮我查询一笔交易信息
我卡里的钱不知道谁划走了？？？？	请帮我查询一笔交易信息
我被骗了，汇了<数字>元给对方，能用什么办法追回来？谢谢	请帮我查询一笔交易信息
银联代收扣的是什么钱	POS交易能查询商户名称吗？
怎么查不了交易	请帮我查询一笔交易信息
错误代码<数字>	POS机出现应答码<数字>是什么意思？
你好，我使用京东闪付在便利店闪付，交易失败，能查到是什么原因吗?	POS机出现应答码<数字>是什么意思？
信用卡<数字>元以下无密码不签字就可以交易，可以取消吗，因为我的信用卡本来就没有设置密码，如果连签字都省了感觉不安全	如何关闭小额免签免密？
我想知道柜面通	某银行有开通柜面通业务吗？
取款密码超过次数怎么办？	借记卡密码输错几次后会被锁定？会锁定多久？
银行卡取款密码输入多次错误，自动锁卡？	借记卡密码输错几次后会被锁定？会锁定多久？
怎么反映商户拒绝我用银行卡	怎么举报套现？
银联商务电话	<数字>
您好，我做了一笔预授权，但为什么冻结了我<数字>%，这是合理的吗	预授权为何会多收<数字>%
请问预授权为什么会多收<数字>%，	预授权为何会多收<数字>%
如何开通闪付功能	如何开通闪付功能
帮我开通闪付	如何开通闪付功能
你好，我想开通我某银行卡的短信提醒功能	你好，我想开通我某银行卡的短信提醒功能
银联IC非接支付是什么意思？	银联IC非接支付是什么意思？
银联IC卡非接支付是什么意思	银联IC非接支付是什么意思？
银联IC卡闪付是怎么付款？	银联IC非接支付是什么意思？
所有银行的银联卡都支持闪付吗	所有银行的银联卡都支持闪付吗
怎么查询POS机是一清，还是二清	怎么查询POS机是一清，还是二清
我的卡有笔扣款，显示广州银联网络有限公司，这是你们单位吗	我的卡有笔扣款，显示广州银联网络有限公司，这是你们单位吗
广州银联网络支付有限公司扣款	我的卡有笔扣款，显示广州银联网络有限公司，这是你们单位吗
广州银联给我扣了一笔钱	我的卡有笔扣款，显示广州银联网络有限公司，这是你们单位吗
POS机退款查询	POS机退款查询
我刷卡的时候POS机提示冲正，什么是冲正啊	我刷卡的时候POS机提示冲正，什么是冲正啊
被盗刷了怎么办	被盗刷了怎么办
你好，我的信用卡被盗刷了，银行那边查不到详细支付信息，我想了解一下	被盗刷了怎么办
我有笔支付感觉像被盗刷，能帮我查看下么	被盗刷了怎么办
我的银行卡被盗刷了，<数字>	被盗刷了怎么办
你好，我遭到电信诈骗，信用卡上的钱全部被盗刷，现在我该怎么办	被盗刷了怎么办
你好，我的银行卡被盗刷，可以帮我查到我的钱的去向吗	被盗刷了怎么办
我的银联卡被盗刷了，银行提供我信息，需要查一下交易地点	被盗刷了怎么办
冲正是什么意思	冲正是什么意思
你好，冲正是什么意思？	冲正是什么意思
消费冲正是什么意思？	冲正是什么意思
我上周晚上到超市刷银联IC卡，银联卡怎么刷不了，帮我查下什么原因	我上周某时间到超市某地刷银联IC卡银联卡怎么刷不了，帮我查下什么原因
你好，我想查一笔跨行转账的进度	你好，我想查一笔跨行转账的进度
什么是MCC	什么是MCC
你们上海长宁区分公司的电话是多少	银联分公司电话如何查询
银联分公司电话如何查询	银联分公司电话如何查询
银联的自助查询方式有哪些	银联的自助查询方式有哪些
<数字>怎么自助查询交易	银联的自助查询方式有哪些
我想查一下我在银联钱包的晒单红包什么时候到账	我想查一下我在银联钱包的晒单红包什么时候到账
帮我解除一下风控	为什么在线支付报错<数字>
你好，一直提示超出银行卡支付上限，怎么处理？	为什么在线支付报错<数字>
无法绑定银行卡	为什么支付不成功
不允许通道前置	为什么支付不成功
该银行不允许通道前置	为什么支付不成功
你好我绑定建行卡为什么说我信息不对	为什么支付不成功
交易通讯超时，什么意思	为什么支付不成功
我们网上缴纳税款点银联扣款为什么老是出错	为什么支付不成功
我在使用您们的银联卡支付时候出现报错	为什么支付不成功
农行怎么不能开通在线支付啊	为什么支付不成功
我刚刚在银联认证的时候说信息不对，是哪方面的原因	为什么支付不成功
支付超额是什么意思	为什么支付不成功
为什么绑不了银行卡	为什么支付不成功
你好，我今天下午用交行储蓄卡在网上支付学习费用，但所有程序操作完之后都显示交易失败，不知道怎么回事	提示交易失败
我们在开通在线银行的时候总是提示银行卡格式不对是什么原因呢	为什么银联在线支付不了
银联在线支付提示预留手机不对	为什么银联在线支付不了
为什么我之前绑定过的农业卡，现在提示不支持？	为什么银联在线支付不了
银联在线支付和网银一样吗？有了网银还需要注册银联在线支付吗	什么是银联在线支付
用银联在线为上海交通卡充值，显示无效商户是怎么回事？	提示交易失败
我在京东银联在线支付使用建行的卡总是支付失败怎么回事	为什么支付不成功
为什么一直显示，持卡和手机号码不符合	银联支付怎么开不了
您好我遇到我的银行卡与一些移动端绑定总提示我预留手机号不符！可我确信我的预留手机号正确呢！	银联支付怎么开不了
我充值时选择其他银行，然后输入银行卡号，为什么老提示错误？	银联支付怎么开不了
开鑫袋绑卡总是失败	银联支付怎么开不了
请问下开通银联支付提示预留电话不对怎么回事呢	为什么支付不成功
开通在线银联时提示文本错误	银联支付怎么开不了
无法开通银联在线支付	为什么支付不成功
你好！我刚刚在网上想开通银联在线支付功能，但是总是开通失败。	银联支付怎么开不了
我这边开通在线支付功能一直说与银行手机不符合	银联支付怎么开不了
交易失败。详情请咨询<数字>(<数字>)这样该怎么处理	交易失败。详情请咨询<数字>(<数字>)
请问现在支付只能支持四大行吗？	目前哪些银行可以用于银联在线支付？
银联在线支付只支持<数字>卡吗	目前哪些银行可以用于银联在线支付？
您好，我想请问一下支持无跳转支付的银行有哪些啊？	目前哪些银行可以用于银联在线支付？
你好，请问用银联，手续费是多少	开通网上支付功能是否需要支付手续费？
关闭支付自助通道	如何关闭银联在线支付？
取消无卡自助消费	如何关闭银联在线支付？
卡号开通银联在线，想取消银联在线。	如何关闭银联在线支付？
银联在线可以取消么？	如何关闭银联在线支付？
发送短信次数超过单位时间上限	短信验证码发送多次被锁，怎么办？
发短信次数超过单位时间次数	短信验证码发送多次被锁，怎么办？
发送短信次数超过总上限	短信验证码发送多次被锁，怎么办？
我刚刚修改的手机号收不到验证码	短信验证码接收异常如何处理？
可以直接用银联卡支付吗	你们担保支持哪些信用卡
我绑定的手机号码没有收到短信验证码的情况下可以通过其他验证方式成功支付吗？	你们担保支持哪些信用卡
手机能开通银联在线支付吗	我问一下用手机浏览器能不能开通在线支付
手机浏览器支持银联在线支付控件安装吗	我问一下用手机浏览器能不能开通在线支付
你好！手机浏览器不能支持安全控件，怎么处理	我问一下用手机浏览器能不能开通在线支付
绑卡时显示暂不支持此浏览器	我问一下用手机浏览器能不能开通在线支付
为什么显示不支持此浏览器	我问一下用手机浏览器能不能开通在线支付
你好，请问那些浏览器可以开通在线支付	我问一下用手机浏览器能不能开通在线支付
我激活的时候说暂不支持此浏览器，那支持哪个浏览器？	我问一下用手机浏览器能不能开通在线支付
不支持浏览器什么意思	我问一下用手机浏览器能不能开通在线支付
为什么提示不支持此浏览器	我问一下用手机浏览器能不能开通在线支付
手机能开通在线支付吗	我问一下用手机浏览器能不能开通在线支付
银联在线支付功能用银联钱包软件能开通吗	我问一下用手机浏览器能不能开通在线支付
证书安装不了怎么办？	安全证书过期了，怎么重新下载安装
末三位要安装个证书	安全证书过期了，怎么重新下载安装
没有网银怎么付款	教师证考试为什么不能用银联卡支付呢？
网银支付左边也没有显示银联卡支付	教师证考试为什么不能用银联卡支付呢？
你好KINDLE包月服务支付方式一定要银联卡吗？	教师证考试为什么不能用银联卡支付呢？
请问网银退款什么时候到账	网银退款到账时间
网银退款多久到账	网银退款到账时间
一直收到短信验证码，但我没操作过	多次收到你们的短信
我咋手机老是收到验证码	多次收到你们的短信
您好，我想问一下银联测试交易卡号等信息在哪里查询？	请问银联测试帐号在哪里查
在输入密码的位置需要下载一个东西吗	什么是安全控件？
银联支付时显示安装控件	什么是安全控件？
我想开通银联支付刚刚注册了账号然后显示要安装控件是什么啊	什么是安全控件？
CHROME<数字>版本的控件不可用啊。	银联在线支付控件安装不上怎么办
控件不能用	银联在线支付控件安装不上怎么办
控件使用不了额	银联在线支付控件安装不上怎么办
为什么我安装了银联卡密码控件后在界面填写资料时老是让我安装控件？	银联在线支付控件安装不上怎么办
我安装了银联安全控件，但网页一直提示我安装	银联在线支付控件安装不上怎么办
银联在线的安全控件现在不能用了	银联在线支付控件安装不上怎么办
银联支付，未到账怎么退款	银联支付，未到账怎么退款
通过银联支付，银行已经扣钱，对方未到账，怎么申请退钱	我买改签火车票付款<数字>次，这里付款成功，但都没改签成功
为什么我付款成功了却未到账	银联支付，未到账怎么退款
你好，我已支付，但是现实未缴费。	银联支付，未到账怎么退款
查询扣费商家	银联支付，未到账怎么退款
为什么我付款了，还一直显示未付款	银联支付，未到账怎么退款
你好，我已经交完<数字>元报名费，可是怎么报名信息还是显示未缴费呢	银联支付，未到账怎么退款
我刚才付款了一笔交易，扣款短信也收到了。但是我缴费的网站显示还是未缴费，怎么回事？	银联支付，未到账怎么退款
为什么银行卡已经扣费，而这边显示支付超时	银联支付，未到账怎么退款
已经扣款但是显示未支付	银联支付，未到账怎么退款
你好，我在日本买飞机票用了银联的在线支付，但是付款后航空公司表示并没有我的订单	银联支付，未到账怎么退款
为什么我用信用卡冲的点卡都一天了还不到帐	我买改签火车票付款<数字>次，这里付款成功，但都没改签成功
这笔订单我交易成功了吗	银联支付，未到账怎么退款
信用卡已经扣款，但网页显示未支付成功怎么回事	银联支付，未到账怎么退款
你好，我支付款项后忘记点返回，确认支付！怎么办？银行那边呢已经扣除费用了	银联支付，未到账怎么退款
网银交易订单号有但中国银联交易记录没有怎么办	网银交易订单号有但中国银联交易记录没有怎么办
您好，在支付页面用企业网银登录支付为何支付不了	您好，在支付页面用企业网银登录支付为何支付不了
怎么来开不了网上银行	您好，在支付页面用企业网银登录支付为何支付不了
请问，招行对公网银支付，流程是什么样的	您好，在支付页面用企业网银登录支付为何支付不了
B<数字>B支付提示用户权限不足	您好，在支付页面用企业网银登录支付为何支付不了
我想知道怎么开通网上银行	您好，在支付页面用企业网银登录支付为何支付不了
填好了退款的书面格式，要怎么发送给银联	在网上填好退款的书面格式，要怎么发给银联
在网上填好退款的书面格式，要怎么发给银联	在网上填好退款的书面格式，要怎么发给银联
怎么取消待支付的订单啊	怎样取消订单
修改及取消订单	怎样取消订单
如何取消订单？	怎样取消订单
亲，在网上商城买的东西，下错订单了，如何取消呢	怎样取消订单
请问我以付款成功了对方一直没回应我我要如何把款项退回呢谢谢	怎样取消订单
为什么没有银联卡帐号支付啊	怎样取消订单
怎样取消订单	怎样取消订单
银联卡盗刷	银联卡盗刷
为什么没有微信付款链接	为什么没有微信付款链接
支付宝不能付款吗？	支付宝不能付款吗？
不可以支付宝吗	支付宝不能付款吗？
能不能直接用支付宝支付？	支付宝不能付款吗？
我支付英国签证费用，但他们网页要求填银行卡取卡密码，正常吗	输入银行卡密码安全性
输入银行卡密码安全性	输入银行卡密码安全性
您好我已经关闭了在线支付功能现在银联账号还能登陆下次支付的时候如果登陆用户名密码能支付吗	您好我已经关闭了在线支付功能现在银联账号还能登陆下次支付的时候如果登陆用户名密码能支付吗
我在开通在线支付时，总显示，身份信息，手机号，或CVN<数字>不正确，怎么办	我在开通在线支付时，总显示，身份信息，手机号，或CVN<数字>不正确，怎么办
错误提示<数字>是什么	错误提示<数字>是什么
交易通讯超时，请发起查询交易（<数字>）	交易通讯超时，请发起查询交易（<数字>）
BB<数字>	<数字>
交易失败，详情请咨询您的发卡行[<数字>]	交易失败，详情请咨询您的发卡行[<数字>]
您好，我用信用卡进行支付提示：交易金额超限[<数字>]	<数字>
当输入储蓄卡号码后点击，出现禁止访问当前页面！[<数字>]，是啥原因？	当输入储蓄卡号码后点击，出现禁止访问当前页面！[<数字>]，是啥原因？
错误码<数字>	<数字>
在英国使用银联卡有什么特殊的要求吗	银行卡能否在境外使用
国际及港澳台可以使用银联卡吗	银行卡能否在境外使用
带银联标识的储蓄卡境外可以用吗？	银行卡能否在境外使用
优惠券怎么使用	如何使用银联钱包优惠券？
银联钱包购买的优惠券过期了怎么办？	银联钱包的优惠券可以退吗？
想解绑银行卡该怎么操作？	如何删除银联钱包已绑定的银行卡？
在电脑端能添加或删除银行卡吗？	如何删除银联钱包已绑定的银行卡？
怎么解绑我的银行卡？	如何删除银联钱包已绑定的银行卡？
请问我的银联绑定我的银行卡，如何解绑	如何删除银联钱包已绑定的银行卡？
我如何将之前绑定的卡从那个账户移除呢	如何删除银联钱包已绑定的银行卡？
我想解绑银行卡号	如何删除银联钱包已绑定的银行卡？
线下可以用银联红包吗？	什么是银联红包？
银联红包是否可以提现	什么是银联红包？
银联积分如何获得？	怎么获取银联红包
红包怎么获得？	怎么获取银联红包
怎么没有找到绑卡入口啊	银联钱包客户端怎么添加银行卡？
如何绑定银行卡	银联钱包客户端怎么添加银行卡？
银联从哪里绑定卡	银联钱包客户端怎么添加银行卡？
关联银行卡	银联钱包客户端怎么添加银行卡？
怎么添加银行卡？	银联钱包客户端怎么添加银行卡？
请问如何将银行卡绑定到银联账户呢	银联钱包客户端怎么添加银行卡？
你好，银联红包退款后会退回吗。	网上使用红包抵扣失败，钱没扣，红包扣了怎么办？
订单没成功，红包显示已使用怎么办	网上使用红包抵扣失败，钱没扣，红包扣了怎么办？
因为余额不足，订单取消，红包没退回怎么办？	网上使用红包抵扣失败，钱没扣，红包扣了怎么办？
我银联钱包的红包没用成功，给我退回来吧	网上使用红包抵扣失败，钱没扣，红包扣了怎么办？
银联红包扣掉了，但是交易没有成功怎么办？	网上使用红包抵扣失败，钱没扣，红包扣了怎么办？
话费充值不到账	为什么手机话费充值已扣款话费未到账？
我的充值话费没到账	为什么手机话费充值已扣款话费未到账？
为什么我通过银联钱包转账的时候提示单笔金额超限L<数字>	银联钱包转账有限额吗？
银行之间转帐，用你们的银联APP是否免费？	银联钱包转账要手续费吗？
亲，最新版本的APP，二维码是在哪里	怎么使用扫码支付？
扫一扫是不是和POS机刷信用卡一样的啊。	怎么使用扫码支付？
银联钱包里的红包不能在京东消费了吗	银联红包可以在哪些商户使用？
我银联钱包里有<数字>元的红包，这个怎么用	银联红包可以在哪些商户使用？
你好，新人<数字>元红包怎么使用	银联红包可以在哪些商户使用？
银联钱包的扫码交易限额是<数字>吗	怎么设置扫码支付的小额免密功能？
怎么注消帐号	如何注销注册用户名？
有一个号不想用了，怎么能清了呢？	如何注销注册用户名？
请问怎么销户	如何注销注册用户名？
亲如何销户啊？	如何注销注册用户名？
我昨天下载的APP,但是我使用感觉不好，我填写了身份信息了，我想注销	如何注销注册用户名？
请问银联钱包如何重设密码	如何修改登录密码？
一个身份证可以实名几个银联钱包帐号	一个身份证可以关联几个银联账户？
你好，请问一个人可以注册几个银联钱包账号呢	一个身份证可以关联几个银联账户？
一个身份证号能注册几个银行钱包账户	一个身份证可以关联几个银联账户？
实名认证，系统显示我的证件号注册用户超限	一个身份证可以关联几个银联账户？
证件号注册用户数超限	一个身份证可以关联几个银联账户？
提示证件注册过多无法认证	一个身份证可以关联几个银联账户？
注册用户超限怎么解决	一个身份证可以关联几个银联账户？
我的银联钱包实名认证的时候说注册超限	一个身份证可以关联几个银联账户？
我实名认证怎么显示实名数量受限啊	一个身份证可以关联几个银联账户？
银联钱包实名认证，注册超限	一个身份证可以关联几个银联账户？
实名认证提示超限	一个身份证可以关联几个银联账户？
一个身份证可以注册几个账号	一个身份证可以关联几个银联账户？
银联钱包绑定银行卡显示身份证超限怎么办	一个身份证可以关联几个银联账户？
我的银联钱包要实名认证，但是输入我的身份证号的时候，提示超出数量	一个身份证可以关联几个银联账户？
我绑卡失败说是证件号注册用户超限	一个身份证可以关联几个银联账户？
你好，请问一个身份证可以注册几个账号	一个身份证可以关联几个银联账户？
证件号注册用户数超限是怎么回事	一个身份证可以关联几个银联账户？
显示：证件号注册用户数超限（BA<数字>）	一个身份证可以关联几个银联账户？
证件用户超限是怎么回事	一个身份证可以关联几个银联账户？
身份证更改	银联账户已关联身份信息可以修改吗？
银联钱包身份证更改	银联账户已关联身份信息可以修改吗？
你好，我银联钱包的身份证绑定错了，想解除绑定怎么弄？	银联账户已关联身份信息可以修改吗？
你好，真实姓名可以更改吗	银联账户已关联身份信息可以修改吗？
银联钱包更改真实姓名	银联账户已关联身份信息可以修改吗？
更改绑定身份证	银联账户已关联身份信息可以修改吗？
您好，我想更换身份证号码	银联账户已关联身份信息可以修改吗？
我注册了现在里面的身份信息和手机号不匹配，如何更正呢	银联账户已关联身份信息可以修改吗？
我要更改身份证号码，为什么不能更改？	银联账户已关联身份信息可以修改吗？
真实姓名不能修改什么办	银联账户已关联身份信息可以修改吗？
手机实名后，如何取消，要换一个人	银联账户已关联身份信息可以修改吗？
我的银联钱包认证身份是老公的名字，现在绑定不了我的卡，怎么处理	银联账户已关联身份信息可以修改吗？
银联钱包怎么重新认证	银联账户已关联身份信息可以修改吗？
台胞证能做实名认证吗	银联账户支持哪些证件进行实名认证呢？
你好！我在手机上要实名认证，可是我用的是台胞证怎么办？	银联账户支持哪些证件进行实名认证呢？
我是台胞，所以没办法实名登记吗	银联账户支持哪些证件进行实名认证呢？
我在实名登记手机上身分证我是台胞证但是没有办法显示	银联账户支持哪些证件进行实名认证呢？
台胞证是否能做实名认证	银联账户支持哪些证件进行实名认证呢？
现在只能选择“身份证”绑定银联卡，没有“港澳台通行证”的选择键，无法绑定	银联账户支持哪些证件进行实名认证呢？
注册银联钱包时手机号码被他人注册了	注册账号时显示已被注册
我的手机号码被别人注册了银联账号，怎么办？	注册账号时显示已被注册
你好，我目前绑定的手机号马上要停机了，不再使用了，想更换手机号怎么弄啊？	注册账号时显示已被注册
我曾用旧的手机号注册过银联账号，现在手机号已经停用，无法接受短信验证码	注册账号时显示已被注册
忘记密码且原来手机号停用	注册账号时显示已被注册
不记得密码了，手机号换了怎么办	注册账号时显示已被注册
手机号码被别人注册过怎么办	注册账号时显示已被注册
我以前的手机号码绑定了身份信息。现在换号了，可是必须要验证码，上不去，咋办	注册账号时显示已被注册
手机号码换过了，怎么登陆？	注册账号时显示已被注册
你好，我在注册时提示已注册,但我从来没有注册过呀。	注册账号时显示已被注册
我在注册时，说我手机号已经被占用	注册账号时显示已被注册
手机号码被他人注册使用怎么办？	注册账号时显示已被注册
手机号变更，密码忘记了，如何处理？	注册账号时显示已被注册
手机号停用了，忘记密码怎么办？	注册账号时显示已被注册
我的银联密码忘记了，手机号也早就换了，怎么办啊	注册账号时显示已被注册
手机号不用了，密码忘了	注册账号时显示已被注册
注册账号时显示已被注册	注册账号时显示已被注册
我忘了密码也忘了要回答的问题，怎么重新设密码？	如何寻回安全问题答案？
找回安全问题答案	如何寻回安全问题答案？
我只有手机号，现在密码忘了，答案也忘了	如何寻回安全问题答案？
寻回安全问题答案	如何寻回安全问题答案？
以前的身份证号是<数字>位，现在想更改成<数字>位，怎么操作	如何将<数字>位身份证改成<数字>位？
如何将<数字>位身份证改成<数字>位？	如何将<数字>位身份证改成<数字>位？
银行认证码如何获取	银联认证码怎么获取
银联认证码	银联认证码怎么获取
征信验证码	银联认证码怎么获取
银联认证码怎么搞？	银联认证码怎么获取
如何获得银联认证码	银联认证码怎么获取
银联验证码如何获得	银联认证码怎么获取
银联认证码怎么获得啊	银联认证码怎么获取
请问银联<数字>位数的认证码怎么查	银联认证码怎么获取
我的银联认证码是多少	银联认证码怎么获取
征信查询中需要银联认证码，怎么获得？	银联认证码怎么获取
中国人民银行征信中心的“银联认证码”怎么操作的	银联认证码怎么获取
什么银行的卡支持在人行征信平台进行验证	征信支持哪些银行卡验证？
目前个人征信验证，银联支持哪几家银行	征信支持哪些银行卡验证？
华为钱包添加不了建行卡，提示失败的原因是此卡存在风险，该如何处理？	我要为华为PAY绑卡，提示有风险，该怎么办？
我要为华为PAY绑卡，提示有风险，该怎么办？	我要为华为PAY绑卡，提示有风险，该怎么办？
如何申请三星PAY	如何申请三星PAY
MIPAY支持中信银行吗	MIPAY支持中信银行吗
二维码业务是什么？	银联二维码支付产品是什么？
支持银联二维码支付的银行有哪些？	哪些APP具备被扫消费功能？
能给下上海支持扫码付的适用商户链接吗	哪些商户可以使用被扫消费支付？
你好，请问上海这边能支持扫码付的商家有哪些	哪些商户可以使用被扫消费支付？
你好，能否提供下你们银联扫码付支持的上海商户列表	哪些商户可以使用被扫消费支付？
你好，请问扫码付跟闪付一样吗，哪些地方可以使用扫码付，有什么样的标志吗	哪些商户可以使用被扫消费支付？
北京支持扫码付的商家有哪些	哪些商户可以使用被扫消费支付？
哪里可以查询支持扫码付的商家	哪些商户可以使用被扫消费支付？
请问北京支持银联二维码的商户有哪些？有超市吗？	哪些商户可以使用被扫消费支付？
银联扫码付支持哪些商户？	哪些商户可以使用被扫消费支付？
银联钱包二维码支付是用银行卡的支付密码吗？	银行客户端的二维码支付是否需要输入密码？
你好，银联支付扫二维码，需要下载什么软件，怎么操作？	我是民生银行的工作人员，需要咱们银联二维码的资料
我是民生银行的工作人员，需要咱们银联二维码的资料。	我是民生银行的工作人员，需要咱们银联二维码的资料
银联的二维码支付怎么使用？	银联的二维码支付怎么使用？
银联钱包的二维码支付支持哪些银行？	银联钱包的二维码支付支持哪些银行？
我在香港怎么拨打你们客服电话	香港银联客服电话
我在澳门怎么拨打你们客服电话	澳门银联客服电话
我在台湾怎么拨打你们客服电话	台湾银联客服电话
我在日本怎么拨打你们客服电话	日本银联客服电话
我在韩国怎么拨打你们客服电话	韩国银联客服电话
我在新加坡怎么拨打你们客服电话	新加坡银联客服电话
我在马来西亚怎么拨打你们客服电话	马来西亚银联客服电话
我在泰国怎么拨打你们客服电话	泰国银联客服电话
我在越南怎么拨打你们客服电话	越南银联客服电话
我在菲律宾怎么拨打你们客服电话	菲律宾银联客服电话
我在印尼怎么拨打你们客服电话	印尼银联客服电话
我在文莱怎么拨打你们客服电话	文莱银联客服电话
我在阿联酋怎么拨打你们客服电话	阿联酋银联客服电话
我在澳大利亚怎么拨打你们客服电话	澳大利亚银联客服电话
我在新西兰怎么拨打你们客服电话	新西兰银联客服电话
我在美国怎么拨打你们客服电话	美国银联客服电话
我在加拿大怎么拨打你们客服电话	加拿大银联客服电话
我在巴西怎么拨打你们客服电话	巴西银联客服电话
我在阿根廷怎么拨打你们客服电话	阿根廷银联客服电话
我在秘鲁怎么拨打你们客服电话	秘鲁银联客服电话
我在哥伦比亚怎么拨打你们客服电话	哥伦比亚银联客服电话
我在英国怎么拨打你们客服电话	英国银联客服电话
我在法国怎么拨打你们客服电话	法国银联客服电话
我在德国怎么拨打你们客服电话	德国银联客服电话
我在意大利怎么拨打你们客服电话	意大利银联客服电话
我在瑞士怎么拨打你们客服电话	瑞士银联客服电话
我在西班牙怎么拨打你们客服电话	西班牙银联客服电话
我在奥地利怎么拨打你们客服电话	奥地利银联客服电话
我在葡萄牙怎么拨打你们客服电话	葡萄牙银联客服电话
我在丹麦怎么拨打你们客服电话	丹麦银联客服电话
我在瑞典怎么拨打你们客服电话	瑞典银联客服电话
我在挪威怎么拨打你们客服电话	挪威银联客服电话
我在匈牙利怎么拨打你们客服电话	匈牙利银联客服电话
我在波兰怎么拨打你们客服电话	波兰银联客服电话
我在冰岛怎么拨打你们客服电话	冰岛银联客服电话
我在爱尔兰怎么拨打你们客服电话	爱尔兰银联客服电话
我在比利时怎么拨打你们客服电话	比利时银联客服电话
我在卢森堡怎么拨打你们客服电话	卢森堡银联客服电话
我在捷克怎么拨打你们客服电话	捷克银联客服电话
我在斯洛伐克怎么拨打你们客服电话	斯洛伐克银联客服电话
我在土耳其怎么拨打你们客服电话	土耳其银联客服电话
我在希腊怎么拨打你们客服电话	希腊银联客服电话
我在俄罗斯怎么拨打你们客服电话	俄罗斯银联客服电话
我在南非怎么拨打你们客服电话	南非银联客服电话
我在毛里求斯怎么拨打你们客服电话	毛里求斯银联客服电话
我在埃及怎么拨打你们客服电话	埃及银联客服电话
<数字>打了几个小时没人接电话	为什么客服电话打不通
<数字>打不通	为什么客服电话打不通
<数字>的电话太难打通了，好几天都打不通。	为什么客服电话打不通
富友的电话	富友的电话
如何使用机场<数字>元停车礼遇?	什么是机场<数字>元停车礼遇?
机场<数字>元停车是什么意思？	什么是机场<数字>元停车礼遇?
我的卡是白金卡/钻石卡可以参与机场<数字>元停车吗？	什么是机场<数字>元停车礼遇?
什么银行的卡可以享受机场<数字>元停车礼遇？	什么是机场<数字>元停车礼遇?
信用卡可以享受机场<数字>元停车礼遇吗？	什么是机场<数字>元停车礼遇?
借记卡可以享受机场<数字>元停车礼遇吗？	什么是机场<数字>元停车礼遇?
储蓄卡可以享受机场<数字>元停车礼遇吗？	什么是机场<数字>元停车礼遇?
机场<数字>元停车对银行卡有什么要求吗？	什么是机场<数字>元停车礼遇?
我想参加机场<数字>元停车活动。	什么是机场<数字>元停车礼遇?
什么是机场<数字>元停车礼遇?	什么是机场<数字>元停车礼遇?
APPLEPAY可以享受机场<数字>元停车吗？	机场<数字>元停车礼遇可以用云闪付付款吗？
华为PAY可以享受机场<数字>元停车吗？	机场<数字>元停车礼遇可以用云闪付付款吗？
三星PAY可以享受机场<数字>元停车吗？	机场<数字>元停车礼遇可以用云闪付付款吗？
米PAY可以享受机场<数字>元停车吗？	机场<数字>元停车礼遇可以用云闪付付款吗？
云闪付可以享受机场<数字>元停车吗？	机场<数字>元停车礼遇可以用云闪付付款吗？
机场<数字>元停车可以用手机刷吗？	机场<数字>元停车礼遇可以用云闪付付款吗？
机场<数字>元停车可以用APPLEPAY刷吗？	机场<数字>元停车礼遇可以用云闪付付款吗？
机场<数字>元停车可以用三星PAY刷吗？	机场<数字>元停车礼遇可以用云闪付付款吗？
机场<数字>元停车可以用华为PAY刷吗？	机场<数字>元停车礼遇可以用云闪付付款吗？
机场<数字>元停车礼遇可以用云闪付付款吗？	机场<数字>元停车礼遇可以用云闪付付款吗？
我还能使用几次机场<数字>元停车权益？	如何查看机场<数字>元停车礼遇剩余使用次数？
我的机场<数字>元停车权益剩几次了？	如何查看机场<数字>元停车礼遇剩余使用次数？
我用过几次机场<数字>元停车权益了？	如何查看机场<数字>元停车礼遇剩余使用次数？
如何查看机场<数字>元停车礼遇剩余使用次数？	如何查看机场<数字>元停车礼遇剩余使用次数？
机场<数字>元停车可以用几次？	机场<数字>元停车礼遇有使用次数限制吗？
钻石卡可以使用几次机场<数字>元停车权益？	机场<数字>元停车礼遇有使用次数限制吗？
白金卡可以使用几次机场<数字>元停车权益？	机场<数字>元停车礼遇有使用次数限制吗？
我的卡可以使用几次机场<数字>元停车权益？	机场<数字>元停车礼遇有使用次数限制吗？
机场<数字>元停车礼遇有使用次数限制吗？	机场<数字>元停车礼遇有使用次数限制吗？
我的银行卡可以使用机场<数字>元停车权益吗？	什么银行的卡可以使用机场<数字>元停车礼遇?
我的钻石卡可以使用机场<数字>元停车权益吗？	什么银行的卡可以使用机场<数字>元停车礼遇?
我的白金卡可以使用机场<数字>元停车权益吗？	什么银行的卡可以使用机场<数字>元停车礼遇?
什么银行的卡可以使用机场<数字>元停车礼遇?	什么银行的卡可以使用机场<数字>元停车礼遇?
机场<数字>元停车权益有起止时间吗？	机场<数字>元停车礼遇什么时候结束？
机场<数字>元停车哪天结束？	机场<数字>元停车礼遇什么时候结束？
机场<数字>元停车权益结束了吗？	机场<数字>元停车礼遇什么时候结束？
机场<数字>元停车权益到哪天？	机场<数字>元停车礼遇什么时候结束？
今天/明天/后天还能使用机场<数字>元停车权益吗？	机场<数字>元停车礼遇什么时候结束？
机场<数字>元停车礼遇什么时候结束？	机场<数字>元停车礼遇什么时候结束？
怎么使用商场停车权益？	什么是商场停车礼遇？
上海可以使用商场停车权益吗？	什么是商场停车礼遇？
什么是商场停车礼遇？	什么是商场停车礼遇？
什么是住二送一？	什么是星级酒店住两晚送一晚礼遇？
怎么获得住二送一优惠券？	什么是星级酒店住两晚送一晚礼遇？
什么是星级酒店住两晚送一晚礼遇？	什么是星级酒店住两晚送一晚礼遇？
怎么预定住二送一？	如何使用星级酒店住两晚送一晚优惠券？
预定了住二送一可以更改时间吗？	如何使用星级酒店住两晚送一晚优惠券？
预定住二送一后可以更改日期吗？	如何使用星级酒店住两晚送一晚优惠券？
我想使用住二送一优惠券。	如何使用星级酒店住两晚送一晚优惠券？
如何使用星级酒店住两晚送一晚优惠券？	如何使用星级酒店住两晚送一晚优惠券？
住二送一可以兑现吗？	星级酒店住两晚送一晚优惠券含早餐吗？
住二送一含早餐吗？	星级酒店住两晚送一晚优惠券含早餐吗？
住二送一包含服务费吗？	星级酒店住两晚送一晚优惠券含早餐吗？
住二送一可以和酒店其他优惠叠加吗？	星级酒店住两晚送一晚优惠券含早餐吗？
星级酒店住两晚送一晚优惠券含早餐吗？	星级酒店住两晚送一晚优惠券含早餐吗？
喜达屋怎么订？	如何预订喜达屋？
什么是喜达屋权益？	如何预订喜达屋？
我想预定喜达屋。	如何预订喜达屋？
喜达屋权益是怎么预定的？	如何预订喜达屋？
如何预订喜达屋？	如何预订喜达屋？
新西兰便捷签证权益是什么？	什么是新西兰便捷签证服务礼遇？
什么是新西兰便捷签证服务礼遇？	什么是新西兰便捷签证服务礼遇？
新西兰便捷签证权益截止到哪一天？	新西兰便捷签证服务起止时间是？
新西兰便捷签证权益哪天结束？	新西兰便捷签证服务起止时间是？
新西兰便捷签证服务起止时间是？	新西兰便捷签证服务起止时间是？
什么是英国签证加急服务权益？	什么是英国签证加急服务权益？
如何使用英国签证加急服务权益？	如何使用英国签证加急服务权益？
英国签证加急服务权益有什么条件吗？	英国签证加急服务权益有什么条件吗？
英国签证处在哪里？	英国签证处在哪里？
我已经在网上预约了签证加急服务之后才看到银联的免费加急权益怎么办？	我已经在网上预约了签证加急服务之后才看到银联的免费加急权益怎么办？
为什么我已经致电银联预约签证免费加急服务，但被签证中心拒绝承兑了	为什么我已经致电银联预约签证免费加急服务，但被签证中心拒绝承兑了
为什么我已致电银联预约签证免费加急服务，且符合要求，但签证中心窗口工作人员表示没有收到我的申请？	为什么我已致电银联预约签证免费加急服务，且符合要求，但签证中心窗口工作人员表示没有收到我的申请？
凯悦酒店权益是什么？	什么是凯悦酒店集团尊享礼遇？
凯悦酒店权益是什么意思？	什么是凯悦酒店集团尊享礼遇？
什么是凯悦酒店集团尊享礼遇？	什么是凯悦酒店集团尊享礼遇？
怎么预定凯悦酒店权益？	如何享受凯悦酒店集团优惠？
我想预定凯悦酒店权益。	如何享受凯悦酒店集团优惠？
凯悦酒店权益是怎么预定的？	如何享受凯悦酒店集团优惠？
如何享受凯悦酒店集团优惠？	如何享受凯悦酒店集团优惠？
凯悦酒店美食权益是什么？	什么是凯悦酒店珍馐美食尊赏礼遇？
什么是凯悦酒店珍馐美食尊赏礼遇？	什么是凯悦酒店珍馐美食尊赏礼遇？
什么是MEIZUPAY？	什么是MEIZUPAY？
MEIZUPAY是指什么？	什么是MEIZUPAY？
MEIZUPAY是怎么工作的？	MEIZUPAY的工作方式是什么？
MEIZUPAY的工作方式是什么？	MEIZUPAY的工作方式是什么？
MEIZUPAY支持的设备有哪些？	MEIZUPAY支持的设备有哪些？
MEIZUPAY支持的手机型号有哪些？	MEIZUPAY支持的设备有哪些？
什么样的手机支持MEIZUPAY？	MEIZUPAY支持的设备有哪些？
目前哪些银行可以使用MEIZUPAY？	目前哪些银行已经开展了MEIZUPAY？
目前哪些银行已经开展了MEIZUPAY？	目前哪些银行已经开展了MEIZUPAY？
我可以通过发卡银行的APP申请MEIZUPAY吗？	我可以通过发卡银行的APP申请MEIZUPAY吗？
什么是APPLEPAY？	什么是APPLEPAY？
APPLEPAY的定义是什么？	什么是APPLEPAY？
有APPLEPAY的介绍吗？	什么是APPLEPAY？
APPLEPAY的工作方式是什么？	APPLEPAY的工作方式是什么？
什么样的机型和系统支持APPLEPAY？	什么样的机型和系统支持APPLEPAY？
我的手机能用APPLEPAY吗？	什么样的机型和系统支持APPLEPAY？
哪些手机能绑定APPLEPAY	什么样的机型和系统支持APPLEPAY？
APPLEPAY与银联云闪付的关系？	APPLEPAY与银联云闪付的关系？
APPLEPAY是云闪付吗？	APPLEPAY与银联云闪付的关系？
银联云闪付包括APPLEPAY吗？	APPLEPAY与银联云闪付的关系？
银联云闪付标识设计是什么？	银联云闪付标识设计是什么？
云闪付的图标是什么样子的？	银联云闪付标识设计是什么？
有云闪付的图标吗？	银联云闪付标识设计是什么？
哪些银行已经开展了APPLEPAY业务？	哪些银行已经开展了APPLEPAY业务？
APPLEPAY支持哪些银行？	哪些银行已经开展了APPLEPAY业务？
哪些银行支持APPLEPAY吗？	哪些银行已经开展了APPLEPAY业务？
哪些银行可以绑定苹果支付？	哪些银行已经开展了APPLEPAY业务？
如何在IPHONE上注销APPLEPAY云闪付卡	如何在IPHONE上注销APPLEPAY云闪付卡
怎么解除手机上绑定的APPLEPAY云闪付卡	如何在IPHONE上注销APPLEPAY云闪付卡
解绑APPLEPAY里的卡，怎么操作？	如何在IPHONE上注销APPLEPAY云闪付卡
怎么删除手机上绑定的APPLEPAY云闪付卡	如何在IPHONE上注销APPLEPAY云闪付卡
如何在APPLEWATCH上注销APPLEPAY云闪付卡	如何在APPLEWATCH上注销APPLEPAY云闪付卡
APPLEWATCH里的云闪付卡怎么注销掉？	如何在APPLEWATCH上注销APPLEPAY云闪付卡
解绑APPLEWATCH绑定的云闪付卡	如何在APPLEWATCH上注销APPLEPAY云闪付卡
如何在IPAD上注销APPLEPAY云闪付卡	如何在IPAD上注销APPLEPAY云闪付卡
我要注销IPAD里绑定的云闪付卡	如何在IPAD上注销APPLEPAY云闪付卡
在IPAD里绑定的云闪付卡怎么解绑？	如何在IPAD上注销APPLEPAY云闪付卡
如何挂失APPLEPAY的云闪付卡	如何挂失APPLEPAY的云闪付卡
我的手机丢了，但是APPLEPAY里还绑着卡，怎么办？	如何挂失APPLEPAY的云闪付卡
怎么挂失APPLEPAY里所有绑定的云闪付卡	如何挂失APPLEPAY的云闪付卡
如何解挂APPLEPAY的云闪付卡	如何解挂APPLEPAY的云闪付卡
当时把APPLEPAY里绑定的云闪付卡全部挂失了，要怎么取消挂失？	如何解挂APPLEPAY的云闪付卡
目前是否可通过银行客户端申请APPLEPAY	目前是否可通过银行客户端申请APPLEPAY
云闪付怎么申请？苹果支付能通过银行的APP申请吗？	目前是否可通过银行客户端申请APPLEPAY
能不能通过银行软件申请苹果支付	目前是否可通过银行客户端申请APPLEPAY
APPLEPAY可以绑定附属卡吗	APPLEPAY可以绑定附属卡吗
我的副卡能不能绑APPLEPAY	APPLEPAY可以绑定附属卡吗
非<数字>开头的卡是否可以绑定APPLEPAY	非<数字>开头的卡是否可以绑定APPLEPAY
卡号不是<数字>开头的卡能绑定APPLEPAY吗？	非<数字>开头的卡是否可以绑定APPLEPAY
我是工行的卡，但不是<数字>开头的卡，能绑定苹果支付吗	非<数字>开头的卡是否可以绑定APPLEPAY
APPLEPAY是否支持境外卡绑定？	APPLEPAY是否支持境外卡绑定？
我在境外办理的卡片是否可以绑定APPLEPAY？	APPLEPAY是否支持境外卡绑定？
绑定APPLEPAY生成的虚拟卡是否区分借贷记	绑定APPLEPAY生成的虚拟卡是否区分借贷记
APPLEPAY生成的云闪付卡是否区分储蓄卡或信用卡？	绑定APPLEPAY生成的虚拟卡是否区分借贷记
无法在WALLET中自行注销（即删除）设备卡（云闪付卡）	无法在WALLET中自行注销（即删除）设备卡（云闪付卡）
为什么我自己在手机上解绑APPLEPAY绑定的卡解绑不了	无法在WALLET中自行注销（即删除）设备卡（云闪付卡）
在苹果手机上删除苹果支付的卡不成功？	无法在WALLET中自行注销（即删除）设备卡（云闪付卡）
APPLEPAY的实体卡已挂失，设备卡（云闪付卡）是否还需挂失？	APPLEPAY的实体卡已挂失，设备卡（云闪付卡）是否还需挂失？
我绑定APPLEPAY的卡注销了，这张卡还能用APPLEPAY支付吗？	APPLEPAY的实体卡已挂失，设备卡（云闪付卡）是否还需挂失？
我的卡丢了，已经联系银行挂失了实体卡了，APPLEPAY绑定的虚拟卡还需要挂失吗？	APPLEPAY的实体卡已挂失，设备卡（云闪付卡）是否还需挂失？
查询该实体卡关联了多少张APPLEPAY的设备卡（云闪付卡）	查询该实体卡关联了多少张APPLEPAY的设备卡（云闪付卡）
我想查这张卡下面绑定了多少张APPLEPAY的云闪付卡	查询该实体卡关联了多少张APPLEPAY的设备卡（云闪付卡）
怎么查我的卡绑定了多少张APPLEPAY的云闪付卡	查询该实体卡关联了多少张APPLEPAY的设备卡（云闪付卡）
实体卡已更换新卡，WALLET里该如何操作	实体卡已更换新卡，WALLET里该如何操作
我的卡丢了，补办了张新卡，需要在APPLEPAY里重新操作吗？	实体卡已更换新卡，WALLET里该如何操作
卡到期了，换了张新卡，要怎么更新苹果支付里绑定的卡？	实体卡已更换新卡，WALLET里该如何操作
已退出“丢失模式”，为什么设备卡（云闪付卡）仍被暂停？	已退出“丢失模式”，为什么设备卡（云闪付卡）仍被暂停？
为什么已经把苹果手机退出丢失模式了，我的云闪付卡还是不能使用，显示暂停	已退出“丢失模式”，为什么设备卡（云闪付卡）仍被暂停？
为什么苹果手机打开WALLET，设备卡（云闪付卡）显示“已删除”	为什么苹果手机打开WALLET，设备卡（云闪付卡）显示“已删除”
为什么我APPLEPAY申请的虚拟卡在手机上显示已删除？	为什么苹果手机打开WALLET，设备卡（云闪付卡）显示“已删除”
WALLET里绑定的云闪付卡被自动删除	WALLET里绑定的云闪付卡被自动删除
为啥我APPLEPAY里绑的卡我没有操作就自己都没有了？	WALLET里绑定的云闪付卡被自动删除
APPLE手机送去维修（或退货）但没有删除或暂停卡	APPLE手机送去维修（或退货）但没有删除或暂停卡
我的IPHONE坏了，送去修了，但是我忘记解绑APPLEPAY里的卡了，怎么办？	APPLE手机送去维修（或退货）但没有删除或暂停卡
点选设置-通用-还原里的“抹掉所有内容和设置”，已申请的设备卡（云闪付卡）为什么看不到了？	点选设置-通用-还原里的“抹掉所有内容和设置”，已申请的设备卡（云闪付卡）为什么看不到了？
不小心在设置中操作了抹掉所有内容，为什么我APPLEPAY绑定的云闪付卡都没有了？	点选设置-通用-还原里的“抹掉所有内容和设置”，已申请的设备卡（云闪付卡）为什么看不到了？
点选设置-通用-还原里“还原所有设置”及“还原位置与隐私”是否会影响设备卡（云闪付卡）使用？	点选设置-通用-还原里“还原所有设置”及“还原位置与隐私”是否会影响设备卡（云闪付卡）使用？
操作还原设置和还原隐私会影响APPLEPAY的使用吗？	点选设置-通用-还原里“还原所有设置”及“还原位置与隐私”是否会影响设备卡（云闪付卡）使用？
如果更换了手机，我的APPLEPAY设备卡（云闪付卡）在新手机是否还能看到？	如果更换了手机，我的APPLEPAY设备卡（云闪付卡）在新手机是否还能看到？
我换了一个苹果手机，原来苹果手机里绑定的APPLEPAY的虚拟卡可以直接在新的手机里看到吗？	如果更换了手机，我的APPLEPAY设备卡（云闪付卡）在新手机是否还能看到？
我是否可重新申请APPLEPAY设备卡（云闪付卡）？	我是否可重新申请APPLEPAY设备卡（云闪付卡）？
苹果手机换了一个，我同一张卡可以在新的手机重新申请APPLEPAY么？	如果更换了手机，我的APPLEPAY设备卡（云闪付卡）在新手机是否还能看到？
原苹果手机申请的APPLEPAY设备卡（云闪付卡）该如何处理？	原苹果手机申请的APPLEPAY设备卡（云闪付卡）该如何处理？
换了一个手机，原来旧手机里绑定的APPLEPAY的卡要怎么取消？	如果更换了手机，我的APPLEPAY设备卡（云闪付卡）在新手机是否还能看到？
通过备份恢复可以恢复已经申请的APPLEPAY设备卡（云闪付卡）吗？	通过备份恢复可以恢复已经申请的APPLEPAY设备卡（云闪付卡）吗？
IPHONE恢复备份内容不能恢复以前绑定过的云闪付卡吗？	通过备份恢复可以恢复已经申请的APPLEPAY设备卡（云闪付卡）吗？
WALLET里多了一张未申请过得设备卡（云闪付卡）	WALLET里多了一张未申请过得设备卡（云闪付卡）
我的APPLEPAY绑定的卡怎么多了一张不是我自己的卡？	WALLET里多了一张未申请过得设备卡（云闪付卡）
申请设备卡是否有年龄限制？	申请设备卡是否有年龄限制？
有人使用我的卡在其他设备申请APPLEPAY	有人使用我的卡在其他设备申请APPLEPAY
我的卡在别人的手机上申请了APPLEPAY怎么办？	有人使用我的卡在其他设备申请APPLEPAY
APPLEPAY如何在POS机操作？	APPLEPAY如何在POS机操作？
怎么用APPLEPAY刷卡消费？	APPLEPAY如何在POS机操作？
苹果手机怎么在POS机上消费？	APPLEPAY如何在POS机操作？
怎么在刷卡机上刷苹果手机？	APPLEPAY如何在POS机操作？
使用APPLEPAY是否需要密码？	使用APPLEPAY是否需要密码？
POS机消费，苹果支付需要输密码么？	使用APPLEPAY是否需要密码？
使用APPLEPAY在POS机消费需要联网吗？	使用APPLEPAY在POS机消费需要联网吗？
苹果支付在POS机消费的是时候，手机必需要连着网吗？	使用APPLEPAY在POS机消费需要联网吗？
APPLEPAY在POS支付时需要开启WALLET吗？	APPLEPAY在POS支付时需要开启WALLET吗？
在POS机上刷苹果手机需要把WALLET给打开吗？	APPLEPAY在POS支付时需要开启WALLET吗？
在POS机上用APPLEPAY直接刷手机就可以了吗？用打开什么东西吗？	APPLEPAY在POS支付时需要开启WALLET吗？
切换了国家/地区申请APPLEPAY云闪付卡是否会影响使用？	切换了国家或地区申请APPLEPAY云闪付卡是否会影响使用？
不小心把地区设置到香港了，能直接申请APPLEPAY吗？	切换了国家或地区申请APPLEPAY云闪付卡是否会影响使用？
APPLEPAY的POS机打单的卡号为什么与我的银行卡不一样？	APPLEPAY的POS机打单的卡号为什么与我的银行卡不一样？
我用APPLEPAY在POS机上消费，怎么小票上显示的卡号和我自己的卡号不一样啊？	APPLEPAY的POS机打单的卡号为什么与我的银行卡不一样？
APPLEPAY已正常绑卡，但交易失败	APPLEPAY已正常绑卡，但交易失败
我的卡能正常绑定APPLEPAY，为什么一交易就提示失败？	APPLEPAY已正常绑卡，但交易失败
如何查询APPLEPAY设备卡（云闪付卡）交易明细？	如何查询APPLEPAY设备卡（云闪付卡）交易明细？
APPLEPAY绑定的虚拟卡的交易明细怎么查？	如何查询APPLEPAY设备卡（云闪付卡）交易明细？
使用APPLEPAY设备卡（云闪付卡），是否可享受其关联的实体卡的相关权益？	使用APPLEPAY设备卡（云闪付卡），是否可享受其关联的实体卡的相关权益？
他人在本人不知情时通过密码设备而使用其设备卡（云闪付卡）	他人在本人不知情时通过密码设备而使用其设备卡（云闪付卡）
朋友在我不在的时候，使用了我的设备卡怎么办？	他人在本人不知情时通过密码设备而使用其设备卡（云闪付卡）
APPLEPAY设备卡（云闪付卡）POS机支付限额	APPLEPAY设备卡（云闪付卡）POS机支付限额
APPLEPAY绑定的虚拟卡支付在POS机上消费有限额吗？	APPLEPAY设备卡（云闪付卡）POS机支付限额
WALLET中有一张或多张卡过期否会影响其他卡使用吗？	WALLET中有一张或多张卡过期否会影响其他卡使用吗？
我APPLEPAY中有绑定的过期的卡，影响其他在里面绑定的卡使用吗？	WALLET中有一张或多张卡过期否会影响其他卡使用吗？
APPLEPAY是否可以支持ATM取款	APPLEPAY是否可以支持ATM取款
ATM机上能用苹果手机取款吗？	APPLEPAY是否可以支持ATM取款
POS机无法感应APPLE手机进行非接支付	POS机无法感应APPLE手机进行非接支付
为什么在POS机上感应苹果手机没有反映	POS机无法感应APPLE手机进行非接支付
在POS机上用APPLEPAY为啥没有反映？	POS机无法感应APPLE手机进行非接支付
线下商户消费、消费撤销或联机退货时，POS机仅提示刷卡或插卡，但无挥卡提示	线下商户消费、消费撤销或联机退货时，POS机仅提示刷卡或插卡，但无挥卡提示
APPLEPAY交易失败，但是手机WALLET中仍然显示这笔交易	APPLEPAY交易失败，但是手机WALLET中仍然显示这笔交易
APPLEPAY交易失败了，为什么手机上还是显示这笔交易？	APPLEPAY交易失败，但是手机WALLET中仍然显示这笔交易
APPLEPAY如何进行线上支付	APPLEPAY如何进行线上支付
APPLEPAY可以网上交易吗？	APPLEPAY如何进行线上支付
APPLEPAY怎么网上交易	APPLEPAY如何进行线上支付
线上可以在哪些商户使用APPLEPAY设备卡（云闪付卡）支付？	线上可以在哪些商户使用APPLEPAY设备卡（云闪付卡）支付？
APPLEPAY可以在哪些商户网上交易啊？	线上可以在哪些商户使用APPLEPAY设备卡（云闪付卡）支付？
APPLEPAY与APP内购买项目有何区别？	APPLEPAY与APP内购买项目有何区别？
我用APPLEPAY和在APPSTORE里买东西不一样吗？	APPLEPAY与APP内购买项目有何区别？
APPLEPAY交易和在APPSTORE里买东西的区别是什么？	APPLEPAY与APP内购买项目有何区别？
可以更改APPLEPAY自己的默认交易信息吗？	可以更改APPLEPAY自己的默认交易信息吗？
APPLEPAY里默认的交易信息能更改吗？	可以更改APPLEPAY自己的默认交易信息吗？
IPHONE、IPAD已越狱，现在上面有木马APP在执行线上交易	IPHONE、IPAD已越狱，现在上面有木马APP在执行线上交易
手机越狱了，但APP自动在网上交易怎么办？	IPHONE、IPAD已越狱，现在上面有木马APP在执行线上交易
APPLEPAY线上支付是否安全？	APPLEPAY线上支付是否安全？
通过APPLEPAY网上交易安全吗？	APPLEPAY线上支付是否安全？
APPLEPAY怎么保证网上交易的安全？	APPLEPAY线上支付是否安全？
APPLEPAY线上商户是否会保存交易记录？	APPLEPAY线上商户是否会保存交易记录？
我用APPLEPAY网上交易你们后台会记录我的交易信息吗？	APPLEPAY线上商户是否会保存交易记录？
用苹果支付网上支付的交易信息是不是会被保留？	APPLEPAY线上商户是否会保存交易记录？
如何更改其账单地址和送货地址	如何更改其账单地址和送货地址
我想更改苹果支付的账单地址	如何更改其账单地址和送货地址
APPLEPAY的送货地址能更换吗？	如何更改其账单地址和送货地址
APPLEPAY交易如何退款？	APPLEPAY交易如何退款？
APPLEPAY的交易怎么发起退款？	APPLEPAY交易如何退款？
我是通过APPLEPAY交易的，可以退款吗？	APPLEPAY交易如何退款？
APPLEPAY退款是退至哪张卡上？	APPLEPAY退款是退至哪张卡上？
APPLEPAY交易退款了，钱退到那里？	APPLEPAY退款是退至哪张卡上？
通过APPLEPAY操作的预授权交易如何进行预授权完成?	通过APPLEPAY操作的预授权交易如何进行预授权完成?
APPLEPAY做的预授权交易如何完成？	通过APPLEPAY操作的预授权交易如何进行预授权完成?
通过APPLEPAY做的预授权怎么预授权完成？	通过APPLEPAY操作的预授权交易如何进行预授权完成?
对收到的关于功能、服务或交易的电子邮件有疑问	对收到的关于功能、服务或交易的电子邮件有疑问
我不清楚苹果给我发送的邮件里的服务内容是什么？	对收到的关于功能、服务或交易的电子邮件有疑问
APPLEPAY的线上支付时，无法在支付页面直接看到展示的优惠金额	APPLEPAY的线上支付时，无法在支付页面直接看到展示的优惠金额
APPLEPAY参加线上活动的时候,能直接在支付页面看到享受优惠没有吗?	APPLEPAY的线上支付时，无法在支付页面直接看到展示的优惠金额
APPLEPAY线上的活动不能直接看到有没有优惠吗?	APPLEPAY的线上支付时，无法在支付页面直接看到展示的优惠金额
如将WALLET设置为访问限制，是否影响设备卡（云闪付卡）使用	如将WALLET设置为访问限制，是否影响设备卡（云闪付卡）使用
更新IOS软件是否会改变设备卡（云闪付卡）的状态？	更新IOS软件是否会改变设备卡（云闪付卡）的状态？
苹果手机系统升级了会不会改变云闪付卡的状态？	更新IOS软件是否会改变设备卡（云闪付卡）的状态？
有一笔交易需要银联提供纸质证明	有一笔交易需要银联提供纸质证明
我银行卡有一笔显示易办事扣款，银行让我联系你们	我银行卡有一笔显示易办事扣款，银行让我联系你们
银行说银联有赔付机制，是吗？	银行说银联有赔付机制，是吗？
中国银联<数字>微信公众号可以查询哪些交易	中国银联<数字>微信公众号可以查询哪些交易
“中国银联<数字>”微信公众号查询交易次数限制	“中国银联<数字>”微信公众号查询交易次数限制
你们微信公众号可以查询多久的交易	你们微信公众号可以查询多久的交易
自助交易查询可以查询<数字>天以外的交易吗	你们微信公众号可以查询多久的交易
您好，我去物业交费刷卡，物业多收我手续费这合理吗？	某某收我刷卡的手续费，怎么投诉？
如果我在用银联卡进行刷卡消费，但商户要求我支付刷卡费用，可以像银联机构投诉吗？投诉后一般怎么处理呢？	某某收我刷卡的手续费，怎么投诉？
某某收我刷卡的手续费，怎么投诉？	某某收我刷卡的手续费，怎么投诉？
﻿如何开通银联在线支付？	如何开通银联在线支付？
我想开通一下银联支付	如何开通银联在线支付？
在线支付功能怎么弄	如何开通银联在线支付？
如何开通银联无卡业务？	如何开通银联在线支付？
在线支付怎么开	如何开通银联在线支付？
可以帮我开在线支付吗	如何开通银联在线支付？
要如何开通银联支付	如何开通银联在线支付？
帮我开通银联无卡服务	如何开通银联在线支付？
工商卡怎么开通银联支付	如何开通银联在线支付？
银联支付着么开通	如何开通银联在线支付？
在申请在线支付的时候，无法到下一步	如何开通银联在线支付？
开通银联支付怎么进入	如何开通银联在线支付？
在，怎么开通银联支付功能	如何开通银联在线支付？
怎么开通银联支付功能	如何开通银联在线支付？
您好，我想开通一下银联支付功能	如何开通银联在线支付？
您好，我要开通银联网上支付	如何开通银联在线支付？
帮我开通银联支付	如何开通银联在线支付？
您好，请问开通银联支付需要点击哪里	如何开通银联在线支付？
银联支付功能要怎么开通	如何开通银联在线支付？
怎么开通银联支付。	如何开通银联在线支付？
想开通认证服务怎么开通	如何开通银联在线支付？
我想开通银联支付	如何开通银联在线支付？
您好，我的银行卡未开通银联支付功能	如何开通银联在线支付？
您好，开通银联支付怎么操作	如何开通银联在线支付？
我想办个银联在线支付业务	如何开通银联在线支付？
我想咨询一下如何开通银联支付凭证啊	如何开通银联在线支付？
我要怎么开通银联	如何开通银联在线支付？
如何开通银联在线功能	如何开通银联在线支付？
您好，我从哪能查到支持银联在线支付的网站	如何开通银联在线支付？
怎样可以知道是否已经开通了银联在支付？	如何开通银联在线支付？
提示，绑卡失败，该银行卡需开通银联认证支付功能，	如何开通银联在线支付？
您好，开通银联在线的网站是多少	如何开通银联在线支付？
怎么开通银联认证服务啊？	如何开通银联在线支付？
我怎么查询银行卡有没有开通银联	如何开通银联在线支付？
怎么知道自己的卡能不能银联在线支付	如何开通银联在线支付？
办理在线支付	如何开通银联在线支付？
我想开通银联无卡功能	如何开通银联在线支付？
我想开通无卡服务	如何开通银联在线支付？
开通银行支付认证	如何开通银联在线支付？
怎样开通银联支付功能	如何开通银联在线支付？
我要怎样开通银联支付功能呢	如何开通银联在线支付？
怎么弄银联在线支付？？	如何开通银联在线支付？
请开通银联支付功能	如何开通银联在线支付？
银联认证支付功能怎么开通？	如何开通银联在线支付？
如何开通银联无卡支付功能	如何开通银联在线支付？
我绑定连连支付，系统提示我没有在线支付功能，邮政储蓄的卡	邮政储蓄银行
如何办理邮政储蓄银行无卡支付	邮政储蓄银行
麻烦你帮我开通我邮政卡的银联支付	邮政储蓄银行
我想办一个邮政储蓄卡在线支付	邮政储蓄银行
邮政卡开通银联在线	邮政储蓄银行
开通邮政储蓄银联支付	邮政储蓄银行
我的邮储金卡如何开通无卡交易？	邮政储蓄银行
安卓用户如何申请云闪付卡？	安卓用户如何申请云闪付卡？
如何申请云闪付卡？	安卓用户如何申请云闪付卡？
HCE支持哪些银行？	安卓用户如何申请云闪付卡？
哪些银行的客户端支持安卓手机申请云闪付？	安卓用户如何申请云闪付卡？
银联HCE“云闪付”产品适用的手机分别是哪些	银联HCE“云闪付”产品适用的手机分别是哪些
安卓手机可以申请云闪付吗？	银联HCE“云闪付”产品适用的手机分别是哪些
我是步步高的手机，怎么申请手机的闪付功能？	银联HCE“云闪付”产品适用的手机分别是哪些
哪些银行支持安卓手机申请云闪付？	银联HCE“云闪付”产品适用的手机分别是哪些
如何使用HCE云闪付卡在POS机支付？	如何使用HCE云闪付卡在POS机支付？
怎么在POS机上用安卓手机使用云闪付交易	如何使用HCE云闪付卡在POS机支付？
我想用安卓手机的云闪付刷卡消费，怎么操作？	如何使用HCE云闪付卡在POS机支付？
在POS机上怎么刷手机？我是安卓系统的手机	如何使用HCE云闪付卡在POS机支付？
使用HCE云闪付卡是否需要密码？	使用HCE云闪付卡是否需要密码？
安卓手机云闪付付款的时候需要输密码吗？	使用HCE云闪付卡是否需要密码？
HCE支付的时候需要银行卡密码吗？	使用HCE云闪付卡是否需要密码？
HCE有多张云闪付卡时，默认使用哪张云闪付卡进行支付？	HCE有多张云闪付卡时，默认使用哪张云闪付卡进行支付？
安卓手机申请的云闪付可以设置默认支付的卡吗？	HCE有多张云闪付卡时，默认使用哪张云闪付卡进行支付？
HCE云闪付可以设置默认支付卡吗？	HCE有多张云闪付卡时，默认使用哪张云闪付卡进行支付？
如何设置通过银行APP申请的云闪付功能的默认支付卡？	HCE有多张云闪付卡时，默认使用哪张云闪付卡进行支付？
HCE云闪付卡的额度是多少？	HCE云闪付卡的额度是多少？
通过银行APP申请的手机云闪付虚拟卡的额度是多少？	HCE云闪付卡的额度是多少？
HCE云闪付卡交易有限额吗？	HCE云闪付卡的额度是多少？
如何查询HCE云闪付卡的交易明细？	如何查询HCE云闪付卡的交易明细？
手机银行APP申请的云闪付怎么查交易？	如何查询HCE云闪付卡的交易明细？
HCE如何注销云闪付卡？	HCE如何注销云闪付卡？
HCE注销主卡后云闪付卡还能用吗？	HCE如何注销云闪付卡？
怎么解绑HCE云闪付卡？	HCE如何注销云闪付卡？
安卓手机银行APP申请的云闪付卡怎么解绑？	HCE如何注销云闪付卡？
如何挂失HCE云闪付卡？	如何挂失HCE云闪付卡？
如何解挂云闪付卡？	如何挂失HCE云闪付卡？
手机丢了，通过银行APP申请的HCE云闪付虚拟卡需要挂失吗？	如何挂失HCE云闪付卡？
同一手机重新安装手机银行应用，已申请的HCE云闪付卡为什么看不到了？	同一手机重新安装手机银行应用，已申请的HCE云闪付卡为什么看不到了？
手机系统恢复了出厂设置，重新下载了手机银行，为什么我之前绑定的HCE云闪付卡都没有了？	同一手机重新安装手机银行应用，已申请的HCE云闪付卡为什么看不到了？
银行APP卸载重新安装了，之前通过银行客户端申请的闪付虚拟卡还能看到吗？	同一手机重新安装手机银行应用，已申请的HCE云闪付卡为什么看不到了？
手机无法申请/激活/加载HCE云闪付卡	手机无法申请激活加载HCE云闪付卡
为什么通过银行客户端无法申请HCE云闪付卡	手机无法申请激活加载HCE云闪付卡
安卓手机无法通过银行软件申请闪付卡	手机无法申请激活加载HCE云闪付卡
兴业银行客户绑定HCE云闪付卡失败报错“卡片未开通消费凭密”、“超出SEID身份证上限”	兴业银行客户绑定HCE云闪付卡失败报错“卡片未开通消费凭密”、“超出SEID身份证上限”
兴业银行的客户端绑定闪付卡的时候提示：“卡片未开通消费凭密”	兴业银行客户绑定HCE云闪付卡失败报错“卡片未开通消费凭密”、“超出SEID身份证上限”
兴业银行的客户端绑定闪付卡的时候提示：“超出SEID身份证上限”	兴业银行客户绑定HCE云闪付卡失败报错“卡片未开通消费凭密”、“超出SEID身份证上限”
HCE云闪付绑卡报错“未设置消费凭密”	HCE云闪付绑卡报错“未设置消费凭密”
通过银行APP申请手机云闪付时候提示：“未设置消费凭密”	HCE云闪付绑卡报错“未设置消费凭密”
为什么通过银行客户端申请手机闪付的时候提示“未设置消费凭密”	HCE云闪付绑卡报错“未设置消费凭密”
HCE云闪付绑卡报错“RISK_CONTROL_CHECK_FAIL”或“风控查询失败”或“风险系统检查失败”	HCE云闪付绑卡报错“RISK_CONTROL_CHECK_FAIL”或“风控查询失败”或“风险系统检查失败”
HCE云闪付绑卡报错“RISK_CONTROL_CHECK_FAIL”	HCE云闪付绑卡报错“RISK_CONTROL_CHECK_FAIL”或“风控查询失败”或“风险系统检查失败”
HCE云闪付绑卡报错“风控查询失败”	HCE云闪付绑卡报错“RISK_CONTROL_CHECK_FAIL”或“风控查询失败”或“风险系统检查失败”
HCE云闪付绑卡报错“风险系统检查失败”	HCE云闪付绑卡报错“RISK_CONTROL_CHECK_FAIL”或“风控查询失败”或“风险系统检查失败”
手机加载了HCE云闪付银行卡，在POS机上刷卡失败	无法使用HCE云闪付
为什么在银行客户端可以正常绑定云闪付卡，在POS机交易时候提示失败？	无法使用HCE云闪付
为什么我在银行客户端申请的闪付卡在POS机刷没有成功，绑卡是正常绑定的	手机加载了HCE云闪付银行卡，在POS机上刷卡失败
申请HCE云闪付需要在对应的银行有账户吗？	申请HCE云闪付需要在对应的银行有账户吗？
我想通过银行APP申请云闪付卡，需要有我想申请银行的卡吗？	申请HCE云闪付需要在对应的银行有账户吗？
HCE云闪付对应申请的银行卡有借贷记要求吗	HCE云闪付对应申请的银行卡有借贷记要求吗
申请的HCE云闪付卡有储蓄卡和信用卡的分别吗？	HCE云闪付对应申请的银行卡有借贷记要求吗
HCE云闪付银行卡申请后，是否需要对银行卡激活	HCE云闪付银行卡申请后，是否需要对银行卡激活
我的卡已经成功在银行APP上申请到云闪付了，但实体卡没有激活，需要激活吗？	HCE云闪付银行卡申请后，是否需要对银行卡激活
如何获知新申请的HCE云闪付卡号？	如何获知新申请的HCE云闪付卡号？
怎么查我在手机银行APP申请的云闪付卡的卡号？	如何获知新申请的HCE云闪付卡号？
在银行APP申请的云闪付卡能查到完整的卡号吗？	如何获知新申请的HCE云闪付卡号？
HCE云闪付卡交易时手机需要上网吗？	HCE云闪付卡交易时手机需要上网吗？
通过银行APP申请的云闪付卡交易时候，手机必须要联网吗？	HCE云闪付卡交易时手机需要上网吗？
HCE云闪付卡POS交易时需要点击进入银行客户端吗？	HCE云闪付卡POS交易时需要点击进入银行客户端吗？
在POS机上用银行APP申请的云闪付卡交易的时候，银行的客户端需要点开吗？	HCE云闪付卡POS交易时需要点击进入银行客户端吗？
用HCE的时候银行客户端必须打开吗？	HCE云闪付卡POS交易时需要点击进入银行客户端吗？
HCE云闪付是否可以支持ATM取款？	HCE云闪付是否可以支持ATM取款？
能用通过银行APP申请的云闪付在ATM机上取钱吗？	HCE云闪付是否可以支持ATM取款？
取款机上能用手机绑定的HCE云闪付卡取款吗？	HCE云闪付是否可以支持ATM取款？
我的手机已成功申请HCE云闪付卡/云闪付，如果手机丢失，卡内资金被盗刷怎么办？	我的手机已成功申请HCE云闪付卡，如果手机丢失，卡内资金被盗刷怎么办？
手机丢了，通过银行APP绑定的云闪付卡被盗刷了怎么办？	我的手机已成功申请HCE云闪付卡，如果手机丢失，卡内资金被盗刷怎么办？
因为手机丢了通过银行APP申请的云闪付卡被盗刷了，有什么处理方式吗？	我的手机已成功申请HCE云闪付卡，如果手机丢失，卡内资金被盗刷怎么办？
如何申请HCE云闪付的风险保障？	如何申请HCE云闪付的风险保障？
HCE云闪付被盗刷了，有什么保障吗？	如何申请HCE云闪付的风险保障？
无法使用HCE云闪付	无法使用HCE云闪付
HCE如何线上支付？	HCE如何线上支付？
HCE云闪付可以在网上交易吗？	HCE如何线上支付？
通过银行APP申请的云闪付卡怎么在网上付款？	HCE如何线上支付？
HCE云闪付线上支付限额	HCE云闪付线上支付限额
银行APP申请的闪付卡网上交易有限额吗？	HCE云闪付线上支付限额
通过银行APP申请的云闪付网上交易的限额是多少	HCE云闪付线上支付限额
HCE云闪付线上支持银行	HCE云闪付线上支持银行
哪些银行申请的HCE云闪付卡支持网上交易？	HCE云闪付线上支持银行
所有的银行都支持通过银行APP申请的闪付卡在网上交易吗？	HCE云闪付线上支持银行
哪些线上商户可以使用HCE云闪付？	哪些线上商户可以使用HCE云闪付？
什么商户能用HCE云闪付网上付款？	哪些线上商户可以使用HCE云闪付？
银行APP申请的云闪付卡能在哪些软件上付款？	哪些线上商户可以使用HCE云闪付？
HCE云闪付线上支付具体如何使用	HCE云闪付线上支付具体如何使用
介绍一下通过银行APP申请的云闪付卡的网上交易的步骤	HCE云闪付线上支付具体如何使用
怎么在网上用HCE云闪付付款？	HCE云闪付线上支付具体如何使用
如何参加HCE云闪付线上支付营销活动	如何参加HCE云闪付线上支付营销活动
通过银行APP申请的云闪付能参加银联的网上活动吗？	如何参加HCE云闪付线上支付营销活动
我工行申请的是HCE云闪付能在网上用HCE云闪付参加银联的活动么？	如何参加HCE云闪付线上支付营销活动
为什么我在商户的手机客户端内“银联在线支付”支付方式中没有看到HCE云闪付	为什么我在商户的手机客户端内“银联在线支付”支付方式中没有看到HCE云闪付
XXX的手机软件能不能用银行APP申请的云闪付方式网上交易	为什么我在商户的手机客户端内“银联在线支付”支付方式中没有看到HCE云闪付
为什么我无法使用线上HCE云闪付？	为什么我无法使用线上HCE云闪付？
在手机客户端上无法使用银行APP申请的云闪支付怎么办？	为什么我无法使用线上HCE云闪付？
HCE云闪付不能网上交易？	为什么我无法使用线上HCE云闪付？
为什么我的HCE云闪付卡,线上支付时无法显示(获取)	为什么我的HCE云闪付卡，线上支付时无法显示
用HCE线上支付的时候，为什么页面无法显示？	为什么我的HCE云闪付卡，线上支付时无法显示
支持HCE云闪付线上支付的商户APP未看到云闪付的支付入口	支持HCE云闪付线上支付的商户APP未看到云闪付的支付入口
在XX软件想使用HCE云闪付的支付方式，为什么支付页面没有显示？	支持HCE云闪付线上支付的商户APP未看到云闪付的支付入口
HCE云闪付参与线上支付活动时，多次支付不成功并出现系统报错“<数字>”	HCE云闪付参与线上支付活动时，多次支付不成功并出现系统报错“<数字>”
用银行客户端申请的云闪付参加银联的网上活动一直提示<数字>是什么意思？	HCE云闪付参与线上支付活动时，多次支付不成功并出现系统报错“<数字>”
招行卡无法参加“云闪付-HCE卡”营销活动的原因	招行卡无法参加“云闪付-HCE卡”营销活动的原因
招行的HCE云闪付为啥不能参加银联的云闪付的活动？	招行卡无法参加“云闪付-HCE卡”营销活动的原因
招行的银行客户端申请的云闪付不能参加银联的活动吗？	招行卡无法参加“云闪付-HCE卡”营销活动的原因
商户客户端通过HCE云闪付线上交易时无法读取到已申请的云闪付卡	商户客户端通过HCE云闪付线上交易时无法读取到已申请的云闪付卡
为什么我的卡是可以正常申请HCE云闪付功能的，但是在XX客户上支付没有显示	商户客户端通过HCE云闪付线上交易时无法读取到已申请的云闪付卡
